ruber door extension	rubber door extension
gren house kits	greenhouse kits
khols double toilet bowl	kohl's double toilet bowl
spectacide for lawnscarpenter ants	spectracide for lawns carpenter ants
indoor home decor raindeer	indoor home decor reindeer
garlend lights	garland lights
kohlor flush for toilet tank 4421	kohler flush for toilet tank 4421
water softner pellet	water softener pellet
1x4 pre primed mfd trim	1 x 4 pre primed mdf trim
48v to 110 invertor	48v to 110v inverter
ventless gas heters	ventless gas heaters
sable brow grout	sable brown grout
perferated pipe	perforated pipe
floor matt	floor mat
40 wattsolar charged lights	40 watt solar charged lights
fiskers titanium 1 1/2 loppers	fiskars titanium 1 1/2 loppers
ceilig fan mount	ceiling fan mount
silca sand	silica sand
plug in carbon monoxcide	plug in carbon monoxide
balist	ballast
subway title 3 x 6	subway tile 3 x 6
all retaing wall	all retaining wall
pipe swer	pipe sewer
power gable mount attic fac	power gable mount attic fan
metal joinst	metal joist
walnuit stain	walnut stain
hand saw sharpner	hand saw sharpener
step latter	step ladder
36' florescent light bulb	36' fluorescent light bulb
galvinized screws	galvanized screws
furnance gas upflow	furnace gas upflow
rybi power tools	ryobi power tools
10 foot white ethjernet cable	10 foot white ethernet cable
cub cadetcordless hedge trimmer	cub cadet cordless hedge trimmer
door floor plate  slideing doors	door floor plate sliding doors
3 pole range reciptical	3 pole range receptacle
sawall blades	sawzall blades
high boy tolet	highboy toilet
interior doorser	interior doors
corrigaed fiberglass roofing	corrugated fiberglass roofing
mikita 9.5 volt drill	makita 9.5 volt drill
2 inch srew cap	2 inch screw cap
beckett fountin pump	beckett fountain pump
metal double gain boxes	metal double gang boxes
faucet steam washers	faucet stem washers
aluminum three way swich	aluminum three way switch
kids toilet seateat	kids toilet seat eat
gliden premium semi gloss quart	glidden premium semi gloss quart
plant continers	plant containers
tank insualation	tank insulation
layndry tu	laundry tu
heith-zenith motion lights	heath-zenith motion lights
window manganetic lock	window magnetic lock
3500 psi pressue washer	3500 psi pressure washer
patio tille	patio tile
outdoor gfi	outdoor gfci
ridgid       powerwasher  parts	ridgid power washer parts
wet carpet cleaninig	wet carpet cleaning
silk poinsetia	silk poinsettia
white sign lettters	white sign letters
frigidaire water firlters	frigidaire water filters
arylic wood paint	acrylic wood paint
outdoor hightop dining	outdoor high top dining
vinylcorner boards 4 inch	vinyl corner boards 4 inch
exterior wood stainolid color	exterior wood stain color
southren gray tile	southern gray tile
stainles steel door handle	stainless steel door handle
spalted m aple	spalted maple
fireplace screen assessories	fireplace screen accessories
surveilance camera	surveillance camera
frigadaire appliances	frigidaire appliances
glacier bay delmare expresso wall mirror	glacier bay del mar espresso wall mirror
curtin rods	curtain rods
perhung 30x80 interior door	prehung 30 x 80 interior door
screen fame corner	screen frame corner
behr white external semigloss paint	behr white exterior semi gloss paint
rigid 12 volt	ridgid 12 volt
morola tile metro penny	merola tile metro penny
WEBER GRILL GENIS 310	WEBER GRILL GENESIS 310
spgot	spigot
pvc planel glue	pvc panel glue
veranda facia	veranda fascia
pedestial snk	pedestal sink
light fictures	light fixtures
gtxworks trimmer spools	gt worx trimmer spools
frame nail hitschi	frame nailer hitachi
aligator clips	alligator clips
price of 1 gal beher marquee paint	price of 1 gal behr marquee paint
4 inch round bellbox cover	4 inch round bell box cover
steam cleanerm mop	steam cleaner mop
black out doors spray paint	black outdoor spray paint
self contained recepticles	self contained receptacles
presure treated	pressure treated
poulan pro lawn motor blades	poulan pro lawn mower blades
vinyle plankj	vinyl plank
chashing led lights	chasing led lights
externol patio doors	external patio doors
ge gridle	ge griddle
rubber stipper	rubber stopper
mattress foam protecter	mattress foam protector
blinds for portch	blinds for porch
exterior hous shutters	exterior house shutters
3/4 in. wide quarteround	3/4 in. wide quarter round
outdoor seat cushions 24.5 whte	outdoor seat cushions 24.5 white
roman tub faucers	roman tub faucets
front screen for a gazeebo	front screen for a gazebo
fridgidaire water filter	frigidaire water filter
autom tic drawer lite	automatic drawer light
vent a hood dampr	vent a hood damper
whites parkle	white sparkle
dwaft  outside plants	dwarf outside plants
NEUMATIC DOOR ARM	PNEUMATIC DOOR ARM
light switcht sensor	light switch sensor
bousch lazer level gll2-80p	bosch laser level gll2-80p
schluter kurdie	schluter kerdi
flourescent fixture metal parts	fluorescent fixture metal parts
marshaltown 6 inch	marshalltown 6 inch
flexible tourche extension	flexible torch extension
whirl pool water heater pilot	whirlpool water heater pilot
mmirror closet doors	mirror closet doors
cyculer saw	circular saw
insolated cooler with a strap	insulated cooler with a strap
riding lawn mower accesores	riding lawn mower accessories
textered wallpaper	textured wallpaper
vinal latice fence	vinyl lattice fence
hole angel  jig	hole angle jig
outide dog kennel	outside dog kennel
b onnet	bonnet
oscilating fan	oscillating fan
universal faucet connect	universal faucet connector
powervent water heater	power vent water heater
rutic lighting	rustic lighting
ecosmart 90 led daylight br30	ecosmart 90w led daylight br30
ridgid 10000 watt	rigid 10000 watt
cordless drils	cordless drills
accesory bags	accessory bags
bagged cinder mulch	bagged cedar mulch
romanic poetry flat interior paint	romantic poetry flat interior paint
craftman style lights	craftsman style lights
alluminum downspout connector	aluminum downspout connector
elongated bone toilest	elongated bone toilet
white quartz cointertop	white quartz countertop
ridgid job max attatchmens	ridgid jobmax attachments
bonda body filler	bondo body filler
fencde posts	fence posts
hyrdaulic oil for kohler	hydraulic oil for kohler
phillips led sparkle  light bulbs	philips led sparkle light bulbs
1/4 quarter round cherries jublilee	1/4 quarter round cherries jubilee
chamberlain intercomm	chamberlain intercom
60 in. shower door brushed nicker	60 in. shower door brushed nickel
landscape srone	landscape stone
jeffery court mozaic tile	jeffrey court mosaic tile
roybi lazer circular saw	ryobi laser circular saw
scurity screen doors	security screen doors
white glazed 4 tilw	white glazed 4 tile
starter fertillzer	starter fertilizer
cooling towes	cooling towers
ock blade knife piece 3	lock blade knife piece 3
whirlpool apron bathtup	whirlpool apron bathtub
fatpack 18v	fat pack 18v
3oo watt haalogen bulbs	3oo watt halogen bulbs
toliet bowl rebuilding kits	toilet bowl rebuilding kits
matage double oven ranges	maytag double oven ranges
vynal grip strip	vinyl grip strip
garden hose reair kits	garden hose repair kits
perrenial white daisy like	perennial white daisy like
6 stell	6 steel
custom counterto	custom countertop
fire place accessories gas loggs	fireplace accessories gas logs
vynik tiles peel  stick	vinyl tiles peel stick
vanity light fictures	vanity light fixtures
soundfroofing material	soundproofing material
braid trim ceramic title molding	braid trim ceramic tile molding
matte heat resistant pain	matte heat resistant paint
barbeque tools	barbecue tools
incounter gas cook range	encounter gas cook range
rocks hydrophonics	rocks hydroponics
riobi power tool combo	ryobi power tool combo
combo drill makita 20v	combi drill makita 20v
gardenn containers	garden containers
unfinished wide bplanked hickory flooring	unfinished wide plank hickory flooring
outdoor tilees	outdoor tiles
hanging light masn gar	hanging light mason jar
18v drill brushles	18v drill brushless
1/2 inch rubber lep tips	1/2 inch rubber leg tips
xtra wide baby gates	extra wide baby gates
safety latter	safety ladder
exterior shutters byrgundy	exterior shutters burgundy
kholer bathroom wall lights	kohler bathroom wall lights
metal kkitchen cabines	metal kitchen cabinets
DEWALT VACCUM	DEWALT VACUUM
36in vinale fence	36in vinyl fence
kennal kit	kennel kit
pine flooring, tang end grove	pine flooring, tongue and groove
ceeling patio shades	ceiling patio shades
metal sheet underpenning	metal sheet underpinning
cat 5 cable uv restance	cat 5 cable uv resistance
corner sorage	corner storage
3 in 1 vacum, ryobi	3 in 1 vacuum, ryobi
micro fibe	microfiber
phlne batteries	phone batteries
lawm mower	lawn mower
klien lether pouch	klein leather pouch
28x54 replacment window	28x54 replacement windows
lawn sprkinler	lawn sprinkler
3.5 Hindge	3.5 Hinge
skill screwdriver battery	skil screwdriver battery
rayobi blue charger	ryobi blue charger
outdoor coucg	outdoor couch
16 ftdecking boards	16 ft decking boards
weed killer spray contaner	weed killer spray container
wheel borrow	wheelbarrow
24 inche sink and vanity for bath	24 inch sink and vanity for bath
safety glass with perscription	safety glass with prescription
black refrigeratore	black refrigerator
atttic heat barrier	attic heat barrier
blind for paladian	blind for paladin
tolet handle left hand	toilet handle left hand
1/2 gal thermos	1/2 gallon thermos
cover for a double barrow grill	cover for a double barrel grill
window airconditionerwith heaters	window air conditioners with heaters
uplihght	uplight
aftificial prelit christmas trees	artificial prelit christmas trees
medicient cabinet	medicine cabinet
dog leash atachments	dog leash attachments
krass 30 inch kitchen sink	kraus 30 inch kitchen sink
magnetized wall covering	magnetic wall covering
melon sunbrellap	melon sunbrella
set crews for glass	set screws for glass
blakck in decker edger	black and decker edger
marking baint	marking paint
bathroom vanity cabinetwithouttops	bathroom vanity cabinets without tops
drill 20 lithium battery	drill 20v lithium battery
shower fiberglas	shower fiberglass
pressure treated lumber spaint	pressure treated lumber paint
magnet base tool loight	magnetic base tool light
8x8x4 conctete block	8x8x4 concrete block
circular flourecent lights	circular fluorescent lights
outdoor daucets	outdoor faucets
grill cover brinkman double grill	grill cover brinkmann double grill
waterless urinal conversion kist	waterless urinal conversion kit
polyurethane adhesiv	polyurethane adhesive
eucalptus white board	eucalyptus white board
phone linesplice connectors	phone line splice connectors
berhr  solid 213 deep	behr solid 213 deep
eletric pole hedge clippers	electric pole hedge clippers
light switchvers for little girls	light switches for little girls
gentec smoke detector	gentex smoke detector
20v blacker and decker charger	20v black and decker charger
tub faucets bronza	tub faucets bronze
sawzall blades miluakee	sawzall blades milwaukee
cabinet kitchen ligth	cabinet kitchen light
sliding patio doort	sliding patio door
rustollum epoxy	rustoleum epoxy
power toll accesories	power tool accessories
club cadet 46  belt	cub cadet 46 belt
bayonett saw blades	bayonet saw blades
led flashlightts	led flashlights
clacer bay all n one sink	glacier bay all in one sink
replacement shower encosure rod	replacement shower enclosure rod
built in wall nitch	built in wall niche
gunstock oak liamate	gunstock oak laminate
ridgid ipact wrench	rigid impact wrench
fridgdare air conditioners	frigidaire air conditioners
rigid 18v lituim ion nicad	ridgid 18v lithium ion nicad
reprobramable combination lock	programmable combination lock
5 light hanging chandielier	5 light hanging chandelier
show the pric of washer and dryer	show the price of washer and dryer
clawfoot tub cutain	clawfoot tub curtain
lithonia outdoor wall paks	lithonia outdoor wall packs
black postlantern	black post lantern
2ftx3ft industrail rbber mat	2ftx3ft industrial rubber mat
36 inch front dooe with casing	36 inch front door with casing
outside corner- dentil	outside corner- dental
recessed lightjs	recessed lights
peper towel holder wall mount	paper towel holder wall mount
malbu replacement  led light bubles	malibu replacement led light bulbs
offset flang	offset flange
36 vx 72 commercial outdoor mats	36 x 72 commercial outdoor mats
pegro xp coffee step	pergo xp coffee step
hang rials barnyard doors	hang rails barnyard doors
water resistent electrical outlets	water resistant electrical outlets
12 inch hight wall cabinet	12 inch height wall cabinet
FIRE RESTISTANT BOARD	FIRE RESISTANT BOARD
phillips light bulbs	philips light bulbs
peal and stick flashning	peel and stick flashing
driveing bits	driving bits
replacement carbrator for robyi	replacement carburetor for ryobi
403esprit 2x4 ceing tile	403 esprit 2x4 ceiling tile
forced air vents covrs	forced air vents covers
crimpling pleirs	crimping pliers
american standard flush valvu	american standard flush valve
otdoor sola	outdoor solar
smaller single deadbolt lock	small single deadbolt lock
dewalr tools	dewalt tools
top freezer refrigeratot	top freezer refrigerator
frigidair drop in	frigidaire drop in
hose bibb replacement valve	hose bib replacement valve
black decker matris	black decker matrix
tosco ivory tile	tosca ivory tile
anderson window grate	andersen window grate
whiteled tree	white led tree
adirondeck cusion	adirondack cushion
dishwasher water connection vlave	dishwasher water connection valve
6 foot treshold	6 foot threshold
spaonges	sponges
toilet lever kphler brass	toilet lever kohler brass
hallogen bulb  flood	halogen bulb flood
American Standard Bone round toliet	American Standard Bone round toilet
fome core board	foam core board
kerosine heaters	kerosene heaters
cedar 0roofing shingles	cedar roofing shingles
chain sherpeners	chain sharpeners
doors interiorwith door jams	doors interior with door jams
electric lawn mowerectrical	electric lawn mower electrical
klien rg6	klein rg6
ridgid model wd1680 filter	rigid model wd1680 filter
schilage electronic deadbolts locks	schlage electronic deadbolts locks
dark expresso paint for wood	dark espresso paint for wood
dynamic desighn planters	dynamic design planters
25ft huskt tape	25 ft husky tape
dremel toll kit	dremel tool kit
round bulb sting lights	round bulb string lights
pain pot	paint pot
lilac aera rug	lilac area rug
kitchen aide wine and beverage  refrigerator	kitchenaid wine and beverage refrigerator
heating elements for dyer whirlpool	heating elements for dryer whirlpool
30 gal electirc water heater	30 gal electric water heater
drywall mudd	drywall mud
lock brushed nicke;	lock brushed nickel;
ge dish washer with 46 dba rating	ge dishwasher with 46 dba rating
baking panb	baking pan
fireplace mantle	fireplace mantel
schlage plymoth orbit oil rubbed bronze	schlage plymouth orbit oil rubbed bronze
cattale	cattle
kohler chair height elongated toliet	kohler chair height elongated toilet
stainless steele  screws	stainless steel screws
summit 24 inch ss gaqs range	summit 24 inch ss gas range
clock cuitain rod wood	clock curtain rod wood
dog fence batt	dog fence battery
pfister pasedena 4 center set faucet	pfister pasadena 4 center set faucet
aerp garden	aerogarden
did recorder player	dvd recorder player
home decorators mantle green	home decorators mantel green
frostking window shrink film	frost king window shrink film
faucet siphon hose connecter	faucet siphon hose connector
porcalain thinset	porcelain thinset
ceder decking	cedar decking
shop vac aacessories	shop vac accessories
autoficial grass	artificial grass
toliet bowl	toilet bowl
air conditiooning filter 14'	air conditioning filter 14'
1-1/2in. x 1ft. blk pipe	1-1/2in. x 1 ft. black pipe
epoxy concrete pain	epoxy concrete paint
wood buring insert 200-250	wood burning insert 200-250
2000 psi force nozzzle	2000 psi force nozzle
patio flurniture covers	patio furniture covers
upholstry cleaner	upholstery cleaner
pendant shafe	pendant shade
electrical pipe flexable	electrical pipe flexible
ridge power tools combo packs	ridgid power tools combo packs
eat resistant epoxy	heat resistant epoxy
dimable ceiling strip lights	dimmable ceiling strip lights
metal      clothes handing carts	metal clothes hanging carts
pedistal sink, 27'	pedestal sink, 27'
power dprayer	power sprayer
phillips fluorescent 40	philips fluorescent 40
dual mount porcelin kitchen sinks	dual mount porcelain kitchen sinks
gas mowe	gas mower
tood handle lock	todd handle lock
gibrallar post series cedar post	gibraltar post series cedar post
tiki tourches	tiki torches
wall oven combon	wall oven combo
6 foot pation table	6 foot patio table
reflector 50w flurecent	reflector 50w fluorescent
lightsavannah 3-light burnished ing fixtures	light savannah 3-light burnished ing fixtures
recesseingd light housing	recessed light housing
conemporary hanging outdoor light fixture	contemporary hanging outdoor light fixture
sodpstone	soapstone
single board pannel	single board panel
kohler whole houser generator	kohler whole house generator
handi cap sink faucett	handicap sink faucet
Urehtane Foam Sheet	Urethane Foam Sheet
white grey floor tile mosiac	white grey floor tile mosaic
wall scone	wall sconce
sika repair shp	sika repair shop
1x6 toungh  groove	1x6 tongue groove
galvinized poles 20long	galvanized poles 20 long
zinser stain cover	zinsser stain cover
maxx shower door	maax shower door
rust oleum dark hunter green spray enamel paint	rustoleum dark hunter green spray enamel paint
Vigaro fall fertilizer	Vigoro fall fertilizer
auqatic shower & bath	aquatic shower
tolet seats	toilet seats
31x19 one piecs bathroom sink	31x19 one piece bathroom sink
vynal wood fence	vinyl wood fence
jeldewen prairie mission door	jeld wen prairie mission door
bosh cordless combo set	bosch cordless combo set
lo gas water heater	low gas water heater
fisher and penkel	fisher and paykel
metal plate cover gcfi	metal plate cover gfci
gothic fence picketts	gothic fence pickets
robyi gas weeder	ryobi gas weeder
ceilin storage	ceiling storage
strap and t hindge	strap and t hinge
hamptom bay cusion	hampton bay cushion
paint refil tray	paint refill tray
contact paoer	contact paper
whirpool refrigerator	whirlpool refrigerator
premaid stair railing	premade stair railing
concret anchor bolts	concrete anchor bolts
rg6 connecto	rg6 connector
toillet	toilet
pegisas sink top	pegasus sink top
bathroom cabinet without fermaldehyde	bathroom cabinet without formaldehyde
extrior louvored wood door 30x80	exterior louvered wood door 30x80
11 ft extension cord groud	11 ft extension cord ground
ge personal eletrical home security	ge personal electric home security
transmissin leak stopper	transmission leak stopper
24 hollow core closet dor	24 hollow core closet door
shower nitch	shower niche
gutter water reflector	gutter water deflector
8' galvanized roll top edginh	8' galvanized roll top edging
dehumidifyer	dehumidifier
heat ventss	heat vents
mantle brakets	mantle brackets
silding closet doors track	sliding closet doors track
wall paper bprder	wallpaper border
hohler black and tan	kohler black and tan
evaporative thermstate	evaporative thermostat
T-5 florescent light fixtures	T-5 fluorescent light fixtures
florencet light cover	fluorescent light cover
christmas lights icicle colerful	christmas lights icicle colorful
talsrar	talstar
hidden fastners	hidden fasteners
water proof mc connecter	waterproof dc connector
cerowire 12 gauge	cerro wire 12 gauge
baraar emy	bazaar emy
barictric walk in tubs	bariatric walk in tubs
floor slealer	floor sealer
20 ampweather proof recepticles	20 amp weatherproof receptacles
milwankee 7 pc set	milwaukee 7 pc set
wood toold	wood tools
floot ball	float ball
granite colr group prices	granite color group prices
railing kit system round ballusters	railing kit system round balusters
colaroo outdoor shades corded	coolaroo outdoor shades corded
acid stian	acid stain
basemetnt window	basement window
artificial turf for petrs	artificial turf for pets
vynal flooring	vinyl flooring
akkegro	allegro
azelas	azaleas
elecric screw driver batteries	electric screwdriver batteries
pneumatic cynlinder	pneumatic cylinder
roles of concreate mesh	roles of concrete mesh
Shower facuet	Shower faucet
land scaping timbers	landscaping timbers
daltile accent peices	daltile accent pieces
high gloss waterborne acrylic enamal	high gloss waterborne acrylic enamel
rostoluem  spray paint	rustoleum spray paint
melamine sheliving	melamine shelving
apartment size refreidgerator	apartment size refrigerator
mitter saw manual	miter saw manual
hummngbird feeders	hummingbird feeders
unsanded groutr	unsanded grout
milwakee work radio	milwaukee work radio
irrigation pipe connectoer	irrigation pipe connector
martha steward bath mirror	martha stewart bath mirror
kohler glas shower door 4ft	kohler glass shower door 4ft
nutmag mirrors	nutmeg mirrors
toliet bowl wrench	toilet bowl wrench
appache mills plush tiles	apache mills plush tiles
n utdriver bit	nut driver bit
router templit kits letters	router template kits letters
100 watt candlebra	100 watt candelabra
deecals number	decals number
moen brushed nickel batharoom	moen brushed nickel bathroom
pullbehind fertilizer spreader	pull behind fertilizer spreader
milwaukee m18 tootls	milwaukee m18 tools
marbel vinyl tile	marble vinyl tile
cauk saver	caulk saver
grill hasmilton	grill hamilton
gazebo with shelfs	gazebo with shelves
gama sonic winsor pier base	gama sonic windsor pier base
3 paint bbrush	3 paint brush
horizantel fence panel	horizontal fence panel
raised toelit sseat	raised toilet seat
4in pvc  franco cuppling	4in pvc fernco coupling
glass mirrior doors 72x80	glass mirror doors 72x80
anderson storm door screen roller	andersen storm door screen roller
battery cable conector	battery cable connector
koehler shower faucet with spray	kohler shower faucet with spray
g e dishwaaher	g e dishwasher
delta montecello tub faucet	delta monticello tub faucet
36 inch neo angle glass doooors	36 inch neo angle glass doors
behr flat white marque	behr flat white marquee
phillips bugle-head finethread sharp	phillips bugle-head fine thread sharp
brigsg and stations 500 seris	briggs and stations 500 series
brinkman grill	brinkmann grill
taracota drain pan	terracotta drain pan
shoipping cart	shopping cart
decoator chain	decorator chain
8 wre wheel	8 wire wheel
ecco friendly garden hose	eco friendly garden hose
4' r;ubber top set base	4' rubber top set base
hickory cabinett	hickory cabinet
plate for faucet stoper	plate for faucet stopper
hampton bay jewelery armoire wht	hampton bay jewelry armoire white
textured 6 pannel hollow core primed composite prehung inter	textured 6 panel hollow core primed composite prehung inter
dal tile 12x24 porcelaine  black tile	daltile 12x24 porcelain black tile
dishwasher moiunting kit	dishwasher mounting kit
coranado baseboard pine	coronado baseboard pine
kersone heaters	kerosene heaters
hampton bat 26'. w tilt out hamper white	hampton bay 26'. w tilt out hamper white
white semigloass	white semi gloss
SOLDERING IRORN	SOLDERING IRON
porceline faucet handle	porcelain faucet handle
17 1/2 high tolite	17 1/2 high toilet
sprinkler conroller	sprinkler controller
knape vogt baseket	knape vogt basket
extention rail for opener	extension rail for opener
expanding plastic sleeves for scews	expanding plastic sleeves for screws
garden spreklers heads	garden sprinklers heads
dpcam camera	dropcam camera
pivotangle lock hinge	pivot angle lock hinge
sink cutting oard	sink cutting board
kitchen cabiner corner	kitchen cabinet corner
window ac/hehat  units	window ac/heat units
concrette pier	concrete pier
lg stcking kit	lg stacking kit
miror interior doors	mirror interior doors
8x8 ezup canopie cover	8x8 ez up canopy cover
3' electical pipe	3' electrical pipe
concrete saw dewall	concrete saw dewalt
cieling	ceiling
wood lathesw	wood lathes
solar led light dust to dawn	solar led light dusk to dawn
wall pannels	wall panels
misquito	mosquito
kihchen cabinet slidr shelves	kitchen cabinet slide shelves
kitchenaid refrigerator bottom frrezer	kitchenaid refrigerator bottom freezer
laguna porcelin tile	laguna porcelain tile
lp coversion kit maytag dryer	lp conversion kit maytag dryer
viynl patches	vinyl patches
automatic drower closer	automatic drawer closer
40ft aluminumm ladder	40 ft aluminum ladder
73 inch anderson patio screen doors	73 inch andersen patio screen doors
discharge  hose 1.5 inces	discharge hose 1.5 inches
maratha stewart monogram wreath	martha stewart monogram wreath
muliti locks	multi locks
anderson storm doors antique bronze	andersen storm doors antique bronze
dealt portable table saw table	dewalt portable table saw table
2 kindorff straps	2 kindorf straps
window ac insaller	window ac installer
milwoki circular saw	milwaukee circular saw
american sandard 1660.225,	american standard 1660.225,
tankles water heater gas outdoor	tankless water heater gas outdoor
mosaic tile costal mist	mosaic tile coastal mist
chadelier	chandelier
perenial flowers	perennial flowers
joint compund light weight	joint compound lightweight
interor door framed	interior door frame
ice maker cylinoid ge	ice maker solenoid ge
vinylcove base	vinyl cove base
lacross weather pro center	lacrosse weather pro center
kohler pedastal sink	kohler pedestal sink
midnight blue irridecent	midnight blue iridescent
verathane	varathane
structered media	structured media
watterproof cleated boots	waterproof cleated boots
concrere chisel	concrete chisel
kohler elongaterd toilet seat	kohler elongated toilet seat
rigid pipe cutter	ridgid pipe cutter
galvinize 2 in box of screws	galvanized 2 in box of screws
diverter 5 in. tub spout with slip fit connection in chrom	diverter 5 in. tub spout with slip fit connection in chrome
termini mosquito garlic spray	terminix mosquito garlic spray
clear vynil for patio	clear vinyl for patio
walnut porcelian	walnut porcelain
great outdors	great outdoors
insl-x pure step	insl-x sure step
dynasty collecion	dynasty collection
rechargale batteries for solar lights	rechargeable batteries for solar lights
double doors with security licks	double doors with security locks
phillips tuvpl-l 36	philips tuv pl-l 36
30 inch kitchenaide cooktops	30 inch kitchenaid cooktops
drop down ceiling ppanel	drop down ceiling panel
silestone sammples	silestone samples
foam insulaion panels	foam insulation panels
knife sharppener	knife sharpener
amcrest survelliance systems	amcrest surveillance systems
composite fiscia board	composite fascia board
accordion door harware	accordion door hardware
20 amp decor outlet ivory	20 amp decora outlet ivory
12 x 12 porcelian floor and wall tile	12 x 12 porcelain floor and wall tile
honey oak tmolding	honey oak t molding
18x18 teracota porcelain floor tiles	18x18 terracotta porcelain floor tiles
duel mount stainless steel sinks	dual mount stainless steel sinks
braxilian cherry laminate	brazilian cherry laminate
shark rocket filtes	shark rocket filters
l screwa	l screws
cement blodks	cement blocks
digital temp monotor	digital temp monitor
pure air ultra filtration syste,m	pure air ultra filtration system
single granit bathroom vanity	single granite bathroom vanity
giant bird of paridise	giant bird of paradise
6 round headlag bolt	6 round head lag bolt
steqamers	steamers
curtain rod wrp	curtain rod wrap
underthe cabinet microwaves	under the cabinet microwaves
runner commerical	runner commercial
plasticl panels	plastic panels
high output basebord	high output baseboard
machette	machete
36 inxh return air grill	36 inch return air grill
american standard 5324.019 enlongate toilet seat	american standard 5324.019 elongated toilet seat
martha stewart curtiins	martha stewart curtains
rain barrells	rain barrels
darby 18 inch dishwasher	danby 18 inch dishwasher
1/2 in. extension joint	1/2 in. expansion joint
nonadhesive vinyl flooring	non adhesive vinyl flooring
dishs for 8	dishes for 8
concreet enchors	concrete anchors
wheeld  trimmer	wheeled trimmer
vanity top for two vessell	vanity top for two vessel
1/2 inch isp water supply line	1/2 inch ips water supply line
brushed stainless cabin ate hardware	brushed stainless cabinet hardware
GLAZER BAY TOILET	GLACIER BAY TOILET
shelves stailess stel	shelves stainless steel
allure flooring oak expresso	allure flooring oak espresso
interior door lcoks	interior door locks
pressuer control valve	pressure control valve
milwaukee 18-volt lithium-ion cordlessrotary hammerss	milwaukee 18-volt lithium-ion cordless rotary hammers
replace plasticbathroom  towel holder	replace plastic bathroom towel holder
3x5 cemet board	3x5 cement board
floatinf shelving	floating shelving
raised garden  ed	raised garden bed
celing fans hampton bay	ceiling fans hampton bay
paw print doorbe;;	paw print doorbell;;
outdoor extention cords e	outdoor extension cords e
comercial plank doors	commercial plank doors
piano door hing	piano door hinge
chrisymas tree bags	christmas tree bags
small refridgerators	small refrigerators
rubber office chair sweel	rubber office chair wheel
gas wayer heaters	gas water heaters
3/4 inche rock	3/4 inch rock
slid pad	slide pad
charbroil classic	char broil classic
masonry painnt	masonry paint
frameless mirro mount	frameless mirror mount
4 in white recessed haol baffle in soft white	4 in white recessed led baffle in soft white
8x10 outside storage	8x10 outdoor storage
remote controlle light dimmer	remote controlled light dimmer
3 piece bfush set	3 piece brush set
buffer polishewr	buffer polisher
72 inchtrack light	72 inch track light
delta portor shower and tub trim	delta porter shower and tub trim
shaw livng rugs model rac66	shaw living rugs model rac66
natur gas heat	natural gas heat
kohler 3 handle shower reapair kit	kohler 3 handle shower repair kit
undergroud telephone wire	underground telephone wire
hot/cold porcelin handles	hot/cold porcelain handles
cablrail	cable rail
1 1/4 steel ppes	1 1/4 steel pipes
tile scrapper	tile scraper
anderson 4000 windows	andersen 4000 windows
barn doorhinges	barn door hinges
surfacemount kitchen sink	surface mount kitchen sink
ceder mulch	cedar mulch
3 in roung head bolt	3 in round head bolt
30 inch refigrator	30 inch refrigerator
cuctis soil	cactus soil
cerrowire 18 gauge	cerro wire 18 gauge
metal shelfs	metal shelves
towbehind lawn spreaders	tow behind lawn spreaders
plastic tiles pcv	plastic tiles pvc
garge floor paint	garage floor paint
koehler enamel cast iron sink	kohler enameled cast iron sink
raised panel extirior doors	raised panel exterior doors
john deer bagger	john deere bagger
dewalt magnetic drive quide	dewalt magnetic drive guide
tub repair kit procelian	tub repair kit porcelain
carpet remmnant	carpet remnant
living room cabnets	living room cabinets
liquid weed and feeed	liquid weed and feed
decrotive outdoor lighting	decorative outdoor lighting
black and yellow non skip tape	black and yellow non skid tape
gas furnace and hotwater	gas furnace and hot water
3/4 sharkbits	3/4 sharkbite
spunge mop refill	sponge mop refill
eiectric concrte mixer	electric concrete mixer
husky black toll boxes	husky black tool boxes
vynel wall tiles	vinyl wall tiles
danze shower vlve	danze shower valve
screen doors: screen tight doors 32 in. unfinished wood t-ba	screen doors: screen tight doors 32 in. unfinished wood t-bar
kohler shower ddoors for tubs in nickel	kohler shower doors for tubs in nickel
berh deck over	behr deck over
driveway m arkers	driveway markers
melmane wood	melamine wood
clow hammer 16 0z	claw hammer 16 0z
spliter ac unit	splitter ac unit
protective pper	protective paper
strapping for cielings	strapping for ceilings
geld wen 2500 96 x 36	jeld wen 2500 96 x 36
3x6 daltile white 101 kohler	3x6 daltile white k101 kohler
kitchen exaust fan	kitchen exhaust fan
contracor string light	contractor string light
qstatic cling window film	static cling window film
stove adopter	stove adapter
drain cleaneraner machines	drain cleaner machines
dewalt 20v recepicating saw	dewalt 20v reciprocating saw
2X4 SRUDS	2X4 STUDS
fridgedaire fridge	frigidaire fridge
bbostitch tool set	bostitch tool set
masterpeice 72	masterpiece 72
metal 3 tiertrolley	metal 3 tier trolley
hazardous locationlight fixture globe	hazardous location light fixture globe
vynil barackets	vinyl brackets
socket magnectic extension	socket magnetic extension
christmsa dog	christmas dog
laminate tile comercial	laminate tile commercial
zep liquid air fresher	zep liquid air freshener
water proofing connector	waterproof connector
100 amps circuit braker	100 amps circuit breaker
nutru ninja	nutri ninja
liquid itght non metalic	liquid tight non metallic
seed starting mixx	seed starting mix
32 inchvinyl screen doors	32 inch vinyl screen doors
sofet	soffit
hampton bay high gloss jabot laminate	hampton bay high gloss jatoba laminate
exteriro door 30 * 80	exterior door 30 * 80
aa batteried	aa batteries
watt premiere water filters	watt premier water filters
7' hex hed bolt	7' hex head bolt
odl 6' x 6'retractable screens	odl 6' x 6 retractable screens
red devil paint cleanaer	red devil paint cleaner
dermal saw max ultra	dremel saw max ultra
battery poerated motion sensor	battery operated motion sensor
bath room sink accecories	bathroom sink accessories
rat or mice poision	rat or mice poison
full size frigde	full size fridge
leaf guards for stomr windows	leaf guards for storm windows
rayoby batteries	ryobi batteries
7 footaluminum awning	7 foot aluminum awning
sunbrella sipcovers	sunbrella slipcovers
okeefes working hands	o'keeffe's working hands
holegen flood light 35w	halogen flood light 35w
vynal windows	vinyl windows
sliding doos for backyard	sliding doors for backyard
3m wheather stripping	3m weather stripping
stickon shower wall tower	stick on shower wall tower
70 celing fan	70 ceiling fan
undercabinet ligghts	under cabinet lights
46 high output grow florescent bulb	46 high output grow fluorescent bulb
yellow jacket extenison cord	yellow jacket extension cord
ryobi 18v battwery	ryobi 18v battery
allure tile sedon?	allure tile sedona?
swivrl wood anchors	swivel wood anchors
batt insulatiom	batt insulation
rigid compound miter saw	ridgid compound miter saw
gargage storage ideas	garage storage ideas
5000 btu aircondition	5000 btu air conditioner
stainless steel wall pannels	stainless steel wall panels
plus 3 tintet	plus 3 tinted
hampton bay pendent light parts	hampton bay pendant light parts
4 guage use	4 gauge use
30inch flourescent tubes	30 inch fluorescent tubes
hampton bay fan replacemtn	hampton bay fan replacement
contempery ceiling fans	contemporary ceiling fans
ull spectrum plant light	full spectrum plant light
emt stroas	emt straps
vinyl latice	vinyl lattice
double pain windows	double pane windows
hampton bay alenxander oak	hampton bay alexander oak
hamiltton collectin	hamilton collection
wirlpool 30 wide french door	whirlpool 30 wide french door
folfable stool	foldable stool
sewer pipe hoider	sewer pipe holder
motion sensoring black decorative lamp	motion sensing black decorative lamp
apoxy patch	epoxy patch
marroon roof screws	maroon roof screws
kohler lighted tolet seats	kohler lighted toilet seats
boch gll	bosch gll
bottom freezer refrdgerators	bottom freezer refrigerators
montaga bay tile	montego bay tile
brushed nickel knobw	brushed nickel knobs
skill pressure sander	skil pressure sander
welded wire fenching 12 gauge	welded wire fencing 12 gauge
one way scrue removal tool	one way screw removal tool
space saving stoage	space saving storage
water suppy box	water supply box
milwakee 1/2 impact cordless	milwaukee 1/2 impact cordless
biinds and shades	blinds and shades
american standard tiolet flappers	american standard toilet flappers
flpwers for your garden	flowers for your garden
plasic diffuser	plastic diffuser
tumbler dryer hose and claps	tumble dryer hose and clamps
exterieur door 32 inch	exterior door 32 inch
hand pump gfor water	hand pump for water
corion shower base	corian shower base
presusre treated  post	pressure treated post
wireless outdoor thermom	wireless outdoor thermometer
ddummy door knobs interior	dummy door knobs interior
commercial accunts	commercial accounts
airator dishwasher	aerator dishwasher
Habachi	Hibachi
alumiunm gate	aluminum gate
polished chrome cbinet pulls	polished chrome cabinet pulls
door latch uard	door latch guard
all trellisses	all trellises
antique truch	antique truck
vaccum for dw745	vacuum for dw745
wooden curton rod brackets	wooden curtain rod brackets
pressue washer	pressure washer
closet rod 8 n9ickel	closet rod 8 nickel
1x2 appearnce boards	1x2 appearance boards
gasolene generaters and inverters	gasoline generators and inverters
ge spring water heater	geospring water heater
anderson windows 400 seriesimpact resistant	andersen windows 400 series impact resistant
steibler eltron	stiebel eltron
paatio swings	patio swings
white rock daltale	white rock daltile
tools bloowers	tools blowers
magnets for gromets	magnets for grommets
chesnut border edging	chestnut border edging
23' biview surface mount med cab chestnut	23' bi view surface mount med cab chestnut
closet orginizer shoe rack wire	closet organizer shoe rack wire
painters plastice	painters plastic
22.1 refrierator	22.1 refrigerator
ceiling tile square fotage	ceiling tile square footage
tub/hand shoer diverter with trim	tub/hand shower diverter with trim
vaporbarrier, crawl space	vapor barrier, crawl space
old style nailshand forgednails	old style nails hand forged nails
wood paint with primerin blue	wood paint with primer in blue
lspacers for toilet bowl	spacers for toilet bowl
interior primed mdf crown mouldin	interior primed mdf crown moulding
low woltage relay	low voltage relay
woodebn fence panels	wooden fence panels
commercial radient ceiling heaters	commercial radiant ceiling heaters
indoor mounting tpe	indoor mounting tape
wg307work  jaw saw	wg307 worx jawsaw
peat moss bails	peat moss bales
celling light	ceiling light
propain heater	propane heater
seimens typ qt breaker	siemens type qt breaker
charming 18 roll	charmin 18 roll
hurracaine brackets	hurricane brackets
light swith insulation	light switch insulation
samsung black stainles	samsung black stainless
deep frezer with glass cover	deep freezer with glass cover
chain saw eletric	chainsaw electric
replacment clips for wire rack	replacement clips for wire rack
slyvanna motion nite light	sylvania motion nite light
circular saw rrip fence	circular saw rip fence
chocolate brown blackspash	chocolate brown backsplash
untique stone	antique stone
msa safet work hat	msa safety work hat
10 in w 30 in l inetrior vent	10 in w 30 in l interior vent
berber carpeting destiny doeskin	berber carpet destiny doeskin
sjhelf	shelf
metalic silver spray	metallic silver spray
clear eppoxy	clear epoxy
brick morter	brick mortar
mirro shower doors	mirror shower doors
ge water heater egnighter	ge water heater igniter
behr ultra pint	behr ultra paint
solid alium square tubing	solid aluminum square tubing
4inch ligh junction box	4 inch light junction box
buikids toilet seat	buy kids toilet seat
wallmounted garage  shelves	wall mounted garage shelves
1/2' olastic pipe	1/2' plastic pipe
mataeials needed for paver patio	materials needed for paver patio
floating corner shelfing	floating corner shelving
winow wheels	window wheels
table covers waterproff	table covers waterproof
douglas fur fake christmas trees	douglas fir fake christmas trees
japenes lilacs	japanese lilacs
paint quart zise	paint quart size
home alerty	home alert
kitchen aide dishwasher	kitchenaid dishwasher
co smoke detector kiddie	co smoke detector kidde
50 amp turn look plug	50 amp turn lock plug
gardden benches	garden benches
whirpool range	whirlpool range
dimer switch and fan control	dimmer switch and fan control
outdoor artifical lawn	outdoor artificial lawn
infared thermometer	infrared thermometer
asburn mahogany medicine cabinate	ashburn mahogany medicine cabinet
unsanded grout bisquit	unsanded grout biscuit
gerber cohort fine edg knife	gerber cohort fine edge knife
60 wat soft watt 2700k a19 dimibal led	60 watt soft watt 2700k a19 dimmable led
paver bricks scolloped	paver bricks scalloped
dewalt extention cord	dewalt extension cord
cable poter	cable porter
sliding windos locks	sliding window locks
handycap toilets	handicap toilets
lamanet floor cutter	laminate floor cutter
10 x 10 gaxebo garden house	10x10 gazebo garden house
hallway pendendant lighting	hallway pendant lighting
humidifier fulters	humidifier filters
lifeproof carpet sample lower trasure	lifeproof carpet sample lower treasure
replacment mini bulbs	replacement mini bulbs
drop in sink ovel	drop in sink oval
ryobi power chalking gun	ryobi power caulking gun
black decke weed eaters	black decker weed eaters
animal deterent	animal deterrent
milwakee m12 cordless heated jacket	milwaukee m12 cordless heated jacket
glacier bay one pice flapper	glacier bay one piece flapper
led fluoreecent light replacement	led fluorescent light replacement
kitchenaide dishwasher	kitchenaid dishwasher
glacie bay dual flush	glacier bay dual flush
5 tier chandalier	5 tier chandelier
satin nickle door hinge 4 in	satin nickel door hinge 4 in
aluninion circular blade	aluminium circular blade
1/4 lauwan under layment	1/4 lauan underlayment
Ortho Wed B Gone max	Ortho Weed B Gon max
roofing leadders	roofing ladders
stove gas replacement knops	stove gas replacement knobs
24x73 book shelve case white	24x73 bookshelf case white
48 inchled tube	48 inch led tube
prehung door fanlite	prehung door fan lite
perenials	perennials
20 amp tamper resitance duplex receptacle	20 amp tamper resistant duplex receptacle
cool  tube lgts	cool tube lights
heater for refrigertor	heater for refrigerator
built in convectionoven	built in convection oven
heat pump acessories	heat pump accessories
air filter for lawn equitment	air filter for lawn equipment
ridgid auger	rigid auger
paito table and chairs	patio table and chairs
warm whit led bulb	warm white led bulb
whirpool oven 5.1	whirlpool oven 5.1
tiolet	toilet
brownbrick wallpaper	brown brick wallpaper
hot dipped galvinized coil nails	hot dipped galvanized coil nails
light puff defuser	light puff diffuser
black maytag french door refrigirator	black maytag french door refrigerator
roybi gas trimmer repair kit	ryobi gas trimmer repair kit
led blubs	led bulbs
susbenders	suspenders
rust oleum aged iron	rustoleum aged iron
horizontall	horizontal
water heatere drain pan	water heater drain pan
porch liht fixture	porch light fixture
1 light steele sconce	1 light steel sconce
mill valley colle	mill valley college
942196brinkmann 2 burner	942196 brinkmann 2 burner
burgluar bar tool	burglar bar tool
cordless backpack vaccume	cordless backpack vacuum
extension  springes	extension springs
battery opererated lighting	battery operated lighting
congolium	congoleum
quart exterior semi glass enamel	quart exterior semi gloss enamel
mohawk oak wood fllors	mohawk oak wood floors
electic fireplace	electric fireplace
fuel nozzle furnance	fuel nozzle furnace
white vanites with tops	white vanities with tops
polyethylne cap	polyethylene cap
yard walll	yard wall
lowvoltage indoor accent lights	low voltage indoor accent lights
toilet in buisk	toilet in buick
condesate pump	condensate pump
motar for large tilw	mortar for large tile
Florescent Light Bulbs	Fluorescent Light Bulbs
modern shower facuet	modern shower faucet
dollie 600 lbs	dolly 600 lbs
liminate flooring cleaning	laminate flooring cleaning
miracle grow spray dispensers	miracle gro spray dispensers
natural hickery kitchen cabinets	natural hickory kitchen cabinets
dining sets outdo?	dining sets outdoor?
pedestial washer	pedestal washer
vertical door slide mechanis	vertical door slide mechanism
basement  tolet	basement toilet
cabinet ba rpulls in bronze	cabinet bar pulls in bronze
toiet	toilet
female hose connectore	female hose connector
cararra tile	carrara tile
adirondak chair	adirondack chair
wood shelfing	wood shelving
moen posi-temp tim kit	moen posi-temp trim kit
gazhose for dryer machine	gas hose for dryer machine
mount blanv	mont blanc
weather indoor and outpoor temp	weather indoor and outdoor temp
multinozzle spray painting	multi nozzle spray painting
waterroo concrete paint	waterproof concrete paint
electric fireplacewater heaters	electric fireplace water heaters
6 ft ceder fence	6 ft cedar fence
roll roofing lap cemet	roll roofing lap cement
survival babkpack	survival backpack
counter and appliance gaperaser	counter and appliance gap eraser
selenoid for dryer	solenoid for dryer
buit in themostat	built in thermostat
vinil for flors	vinyl for floors
wyndham vanities with no tops	wyndham vanities without tops
capacitor for quaterhorse motor 110 volts	capacitor for quarter horse motor 110 volts
french pation doors with sidepanels	french patio doors with side panels
ridge 18v hammer	ridgid 18v hammer
hanger racc vertical	hanger rack vertical
colpay garage door molding	clopay garage door molding
sodering iron	soldering iron
bathro sinks	bathroom sinks
kolher repair	kohler repair
riobi battery	ryobi battery
accordian door	accordion door
kidie co2	kidde co2
florecent bulb holder	fluorescent bulb holder
60 x 100 aluminun mesh	60 x 100 aluminum mesh
residentialsteel door and frame	residential steel door and frame
charger y maintainer	charger and maintainer
floor warming matt	floor warming mat
12x24 shefl	12x24 shelf
swing hangar hardware	swing hanger hardware
water proff board	waterproof board
mosaic whitel and black tile	mosaic white and black tile
storeage shed	storage shed
bisquit tub refinish kit	biscuit tub refinish kit
wall sconse	wall sconce
miraposa whirlpool tub	mariposa whirlpool tub
washer dryer folding worksurface	washer dryer folding work surface
unfinushed kitchen cabinets	unfinished kitchen cabinets
v ceader board	v cedar board
3/8 pipe galvinized	3/8 pipe galvanized
palmero brushed nickel ceiling fan	palermo brushed nickel ceiling fan
flooring moisture barier	flooring moisture barrier
wheel barrel	wheelbarrow
air conditioner sideays	air conditioner sideways
ridgid fan	rigid fan
led light bulbs dimable spot	led light bulbs dimmable spot
1/2 inch blk iron coupling	1/2 inch black iron coupling
stainless steel ball beating for hinges	stainless steel ball bearing for hinges
110v ectric dryers	110v electric dryers
wall mountreading light	wall mount reading light
stone effect sante cecilia top	stone effects santa cecilia top
vinly seat cleaner	vinyl seat cleaner
plywood edge taope	plywood edge tape
3 x3 marle tile	3x3 marble tile
allure red mahoghany	allure red mahogany
submeribale pedistal sump pump	submersible pedestal sump pump
sofit vents 4x16	soffit vents 4 x 16
lsnd scape trim edger	landscape trim edger
2 ton aircondition	2 ton air conditioner
wood fir plank flooring	wood for plank flooring
milstead vintage maple engineered flooring	millstead vintage maple engineered flooring
FENSE LIGHTING	FENCE LIGHTING
rubber for refridgerators	rubber for refrigerators
maytag refregirator	maytag refrigerator
traficmaster	trafficmaster
martha stewartcabinet pull	martha stewart cabinet pull
24 port patch pane	24 port patch panel
grass turf pavewrs	grass turf pavers
8ft wht veranda post sleeve	8 ft white veranda post sleeve
72 hour carpt	72 hour carpet
porta nailor	porta nailer
pendent light	pendant light
brushed barringnton	brushed barrington
fridgedaire	frigidaire
2 1/2 inch nail boxe	2 1/2 inch nail box
marithon water heater element	marathon water heater element
water taste kits	water test kits
clyvus	clivus
roybi l18v	ryobi l18v
Moem faucet repair	Moen faucet repair
decking hardsware	decking hardware
barbeque grills big and easy	barbecue grills big and easy
5 burnerner brikman gas grill	5 burner brinkmann gas grill
skylites	skylights
ceiling light nickle 2-light	ceiling light nickel 2-light
wheelbarow	wheelbarrow
brinkman grill grates	brinkmann grill grates
hard start capacitator	hard start capacitor
clawfoot tub faucit kit	clawfoot tub faucet kit
round rug for kitch	round rug for kitchen
sink faucet with soap dispencer	sink faucet with soap dispenser
gerber daisies	gerbera daisies
bathroon lighting	bathroom lighting
inflatable pool pumper	inflatable pool pump
rustolem appliance touch up paint	rustoleum appliance touch up paint
10 60 tooth blde	10 60 tooth blade
30 unfinish filler	30 unfinished filler
chlorox	clorox
tub enclouseure with tub	tub enclosure with tub
packing suplies	packing supplies
rewd bird feeder	red bird feeder
cealing fans	ceiling fans
instant  waater heater gas lp	instant water heater gas lp
comercial food processor	commercial food processor
plaskolight ceiling panel	plaskolite ceiling panel
cleaning jeta for whirlpool	cleaning jets for whirlpool
25 watt warmlight bulb	25 watt warm light bulb
water heather	water heater
ridgid planner	ridgid planer
spring set for price fister	spring set for price pfister
Cimmaron	Cimarron
dusk to dawn motion sensoroutdoor lighting fixtures	dusk to dawn motion sensor outdoor lighting fixtures
speacalty bit set	specialty bit set
fabric steam cleamer	fabric steam cleaner
vinyl scrapper for jack hammer	vinyl scraper for jack hammer
linier track pendant	linear track pendant
llhampton bay patio rocker	hampton bay patio rocker
confrence	conference
20 amp surger protector	20 amp surge protector
one way valae	one way valve
surface gringer	surface grinder
frigidare stainless refrig	frigidaire stainless refrig
pencle trim tile	pencil trim tile
repacement toilet handle	replacement toilet handle
faux wood shade 100 jnches	faux wood shade 100 inches
wood and concret stain	wood and concrete stain
swing set accesories	swing set accessories
orbital sanding disck	orbital sanding disc
shope cloths	shop clothes
furiture paint, stain and varnish	furniture paint, stain and varnish
wall excess panel	wall access panel
weed killer consertrated	weed killer concentrate
pass and seymore light cover switch	pass and seymour light cover switch
28 kg washign machine	28 kg washing machine
stainless steel sinl	stainless steel sink
drain stopper exstension	drain stopper extension
ice marker water kits	ice maker water kits
insullation	insulation
calanvreas	calaveras
flourecent  light plastic covers	fluorescent light plastic covers
wirlpool counterdepth side by side refrigrator	whirlpool counter depth side by side refrigerator
undercounter lighs	under counter lights
kohler brushed nickle framless shower doors	kohler brushed nickel frameless shower doors
30 amp generater receptical	30 amp generator receptacle
grage doors	garage doors
medalion	medallion
vinal siding per box	vinyl siding per box
oach lights	coach lights
decorative metal sceen	decorative metal screen
connectorv 30	connector 30
upsidedowncan marker paint	upside down can marker paint
treaded pvc pipe fitting	threaded pvc pipe fitting
plastic florring	plastic flooring
ceiling paint pray	ceiling paint spray
carpot canopy 10x20	carport canopy 10x20
door handle deabolt kit	door handle deadbolt kit
12 light bronze chandilier	12 light bronze chandelier
bathtub deck mouted faucet with sprayer	bathtub deck mounted faucet with sprayer
glaciar bay crystal shower	glacier bay crystal shower
infered heaters	infrared heaters
4x6treaded wood	4x6 treated wood
garage bicyclestorage	garage bicycle storage
ryobi coordless 18v starter kit	ryobi cordless 18v starter kit
white acryllic sheet	white acrylic sheet
join compound wall tile	joint compound wall tile
milwaulkee battery charger	milwaukee battery charger
lawn mower rechargeable batterys	lawn mower rechargeable batteries
behr hawian paint	behr hawaiian paint
1/2  conduet	1/2 conduit
end squicky floor	end squeaky floor
12 valleta	12 valletta
guarge parnel	gauge panel
kholer sink 20x17	kohler sink 20x17
transparant redwood stain	transparent redwood stain
phillips 40t12cw plus florescent tube	phillips 40t12cw plus fluorescent tube
20v dewalt kombo	20v dewalt combo
black laminate shelfing	black laminate shelving
rachet	ratchet
24 inch med oak base	24 inch medium oak base
worklight 500 watt bullbs	worklight 500 watt bulbs
t5 high output ligh	t5 high output light
brick web thin brick flats	brickweb thin brick flats
plastic untility shelves	plastic utility shelves
battub floor mat	bathtub floor mat
pricepfister kitchen faucet g135	price pfister kitchen faucet g135
honolule center drain	honolulu center drain
clamps for unistruct	clamps for unistrut
chome  framed mirror	chrome framed mirror
pressure treated step tread 6ft	pressure treated stair tread 6ft
come along and chaincome along and chain	come along and chain come along and chain
perenial bulb	perennial bulb
towel bar nickel gracier 18'	towel bar nickel glacier 18'
hampton bay brillant maple laminate	hampton bay brilliant maple laminate
bathroom  plummbing	bathroom plumbing
rubbermade shed	rubbermaid shed
dewalt circlular saw blades	dewalt circular saw blades
200 amp outdoor circut breaker panel	200 amp outdoor circuit breaker panel
flexable pipe for propane	flexible pipe for propane
organic leafgrow soil	organic leaf grow soil
lbathroom vanity lights chrome 3	bathroom vanity lights chrome 3
ruotor table	router table
vinyl plank blue slatr	vinyl plank blue slate
samsung refridegrator	samsung refrigerator
red color cauking	red color caulking
milwuakee magnetic drive guide	milwaukee magnetic drive guide
steel builco	steel bilco
white carrara herring bome	white carrara herringbone
duel compression 1/2 x 3/8 valve	dual compression 1/2 x 3/8 valve
reheem performance 75 gal water heater	rheem performance 75 gal water heater
3 gutter oulets	3 gutter outlets
kusshuln concrete mixer	kushlan concrete mixer
cold stem for glacer bay faucets	cold stem for glacier bay faucets
prenneols flower seeds	perennials flower seeds
taupe teasure carpet	taupe treasure carpet
window plastic instulation	window plastic insulation
square soffet vents	square soffit vents
8 guage wire	8 gauge wire
ge mwr filter	ge mwf filter
evap cooler theromsat	evap cooler thermostat
closet maiid cabinets	closet maid cabinets
cellular shade 23.75x37	cellular shade 23.75x 37
high traffic floor polurethane paint	high traffic floor polyurethane paint
65 watt dim able	65 watt dimmable
husky rachet	husky ratchet
kitchen trviso price phister	kitchen treviso price pfister
square ube wood	square cube wood
4 inch insolation	4 inch insulation
3' nailes	3' nails
whitehaus bathroom sinl	whitehaus bathroom sink
sweeping atatchment for weed wacker	sweeping attachment for weed wacker
barcello estates light fi	bercello estates light fi
bathtub faucethandle replacement parts	bathtub faucet handle replacement parts
frameless shwoer panel	frameless shower panel
paint hardner	paint hardener
plastic paint containwes with lid	plastic paint containers with lid
alluminun wire splice	aluminum wire splice
quickrete 50 lb mix	quikrete 50 lb mix
installing sockets for flor	installing sockets for floor
moen banbury 24 in. doubletowel bar	moen banbury 24 in. double towel bar
outdoor ceilikng fan with light	outdoor ceiling fan with light
mirror installation hardwawrd	mirror installation hardware
1/2 tee pvcp	1/2 tee pvc
hhigh efficiency round toilet in white	high efficiency round toilet in white
ge gfi braker 30amp	ge gfci breaker 30 amp
2 squares double 5 vinly siding	2 squares double 5 vinyl siding
plexy glass 24 x 24	plexiglass 24 x 24
lawm mowers	lawn mowers
varnishe	varnish
carburator	carburetor
cabinet handels	cabinet handles
PYWOOD	PLYWOOD
brissell zing vacuum bags	bissell zing vacuum bags
outdoor baners	outdoor banners
moen one handel kitchen faucet repair parts	moen one handle kitchen faucet repair parts
lamated counter tops	laminate countertops
toliet seats	toilet seats
batteryfor alarm system	battery for alarm system
osciallating blade to cut tile	oscillating blade to cut tile
moving trollie	moving trolley
bath mirror cabintes	bath mirror cabinets
27 mivrowave	27 microwave
drawer guides and slides	drawer glides and slides
dremel router acessary	dremel router accessory
1/4 shut off velves	1/4 shut off valves
shower dooroil rubbed bronze	shower door oil rubbed bronze
stone effects backsplash cool fushion	stone effects backsplash cool fusion
scement bags	cement bags
power cordclass 2 power model xy_2900600_u	power cord class 2 power model xy_2900600_u
royobi pedestal grinder wheel	ryobi pedestal grinder wheel
diatemaceous earth	diatomaceous earth
schoolhouse pendqnt light	schoolhouse pendant light
stud popers	stud poppers
countertop soap dispensor	countertop soap dispenser
diamond plate storge unit	diamond plate storage unit
coleman instasmart grill	coleman instastart grill
perry hickory laminte	perry hickory laminate
scikkens  stain	sikkens stain
femaie gas fitting quick disonnect	female gas fitting quick disconnect
trex fenc	trex fence
grohe essencekitchen faucet	grohe essence kitchen faucet
porcelaine cleaner	porcelain cleaner
poyurethane clear satin	polyurethane clear satin
100 amp to 200a lit	100 amp to 200 a lot
andersen vnyl windows	andersen vinyl windows
antic brass chandelier	antique brass chandelier
howards restore a finish	howards restor a finish
safty glasses	safety glasses
pastic qtr round	plastic quarter round
solar post lmapy	solar post lamp
stair unners	stair runners
couner deep refrigerators	counter deep refrigerators
battery operataed wall light	battery operated wall light
anntenias	antennas
light weight coccrete	lightweight concrete
apartment size ge  refrigertor stainless steel	apartment size ge refrigerator stainless steel
hampton bay fenving	hampton bay fencing
toro belt pully	toro belt pulley
whirlpoolstainless steel refrig	whirlpool stainless steel refrig
garage orgnize	garage organizer
baliey window roller shades	bailey window roller shades
siemens double pole gfi	siemens double pole gfci
portable air condtioners	portable air conditioners
huskvarna	husqvarna
hardi lap hanger	hardie lap hanger
byfold hinges	bi fold hinges
PHILLIPS POST LIGHT BULB	PHILIPS POST LIGHT BULB
miwaukee 18v battery and charger	milwaukee 18v battery and charger
28 guage screen	28 gauge screen
hardwood medialons	hardwood medallions
high addhesion primer	high adhesion primer
weed  barier	weed barrier
bear semi transparent cedar stain	behr semi transparent cedar stain
primered floor molding	primed floor molding
webber charcoal grill	weber charcoal grill
two gang carlton switch red dpt	two gang carlton switch red dot
recessed medicien cabinet	recessed medicine cabinet
30 inchesbathroom vanity	30 inches bathroom vanity
mobilehome siding	mobile home siding
ridgid power drve pipe threadrs	ridgid power drive pipe threader
barriar plastic	barrier plastic
phone  spliter	phone splitter
resin shesd	resin sheds
24 swantone vanity top	24 swanstone vanity top
polyurethane collors	polyurethane colors
mystick permanent adhesive value pack	mystik permanent adhesive value pack
bushbutton for door bell	push button for doorbell
vanity topp 31 white	vanity top 31 white
apron sink firecaly two bowl	apron sink fireclay two bowl
pre hu door	pre hung door
granite countertop glu	granite countertop glue
roxul sale n sound	roxul safe n sound
garden solenoide valves	garden solenoid valves
cpipe lamp	pipe lamp
handical rail	handicap rail
armazone	amazon
weatherside purit	weatherside purity
dealt 8v screwdriver	dewalt 8v screwdriver
1 1/4 pvcsch 80	1 1/4 pvc sch 80
is item at homedop	is item at home depot
snow blowerr scraper blade	snowblower scraper blade
husky 46 9 drawer mobil	husky 46 9 drawer mobile
mirroes for doors	mirrors for doors
sandpap	sandpaper
cedar wod chips	cedar wood chips
remote meat thermom	remote meat thermometer
braid nailer combo kit	brad nailer combo kit
battery under counter lightening	battery under counter lighting
nutone ventiliation fan parts	nutone ventilation fan parts
claw tups	claw tips
commerical tile	commercial tile
armstrong hardwood flooring422250z5p	armstrong hardwood flooring 422250z5p
charlston south carolina	charleston south carolina
22.4 cubit feet refrigerator	22.4 cubic feet refrigerator
stainless steel grat	stainless steel grate
llantana	lantana
air ventalation deflector	air ventilation deflector
frigidare refrigerator	frigidaire refrigerator
colbolt drill bits	cobalt drill bits
tub surround pices	tub surround prices
framed inerior door	framed interior door
chicken wire 16 gauze	chicken wire 16 gauge
blcktop repair kit	blacktop repair kit
fridgidaire dehumidifier	frigidaire dehumidifier
pilla windows	pella windows
Porach Light	Porch Light
grqss	grass
trash caninet slide	trash cabinet slide
genie excellartor garage door opener	genie excelerator garage door opener
plactic totes  36 inches wide	plastic totes 36 inches wide
kitchen floor tikles	kitchen floor tiles
1.4 mircowave over the stove	1.4 microwave over the stove
earthquaike	earthquake
kraylon non skid	krylon non skid
doorbell chimes and transformr	doorbell chimes and transformer
fenching and gate latches	fencing and gate latches
Club cadet primer bulb	Cub cadet primer bulb
shower pad porceleain	shower pan porcelain
chase lounger covers	chaise lounge covers
jigsaw  tblades	jigsaw t blades
maytag two door refridgerator	maytag two door refrigerator
5 1/4 deckboard	5 1/4 deck board
kkohler toilet seat	kohler toilet seat
fiet electric led gu10	feit electric led gu10
medecine cabinet	medicine cabinet
bbq burner replacment	bbq burner replacement
white lacquer wall selves	white lacquer wall shelves
belt anf tie rack	belt and tie rack
kitchen cabinet with counertop	kitchen cabinet with countertop
black cherry stainer	black cherry stain
cushions outdoorlounge	cushions outdoor lounge
transormations	transformations
miracle grow garden soil	miracle gro garden soil
outside deck boards composit	outside deck boards composite
fuacet	faucet
celliling light	ceiling light
atic  fans with lubers	attic fans with louvers
baby gurad gate	baby guard gate
ligh chrismas hanging tree	light christmas hanging tree
feerzer	freezer
electrian	electrician
deocorative screws for hanging pictures	decorative screws for hanging pictures
how mustall tankless water heater	how install tankless water heater
non programmable vertical  thermost	non programmable vertical thermostat
melomine accessories	melamine accessories
rubbermaid verital sheds	rubbermaid vertical sheds
front foor 2 siding	front door 2 siding
mobilehome wall paint	mobile home wall paint
gas range slide inove	gas range slide in love
ligt fixture covers	light fixture covers
security gate pannel	security gate panel
facia corner brace	fascia corner brace
millwaukee 1/2 ele.c drill	milwaukee 1/2 elec drill
outodoor oatoman	outdoor ottoman
bath bord	bath board
versabon 50lb	versabond 50 lb
needel valve	needle valve
10x12 outdoor gazabos	10x12 outdoor gazebos
landry sink	laundry sink
pegs for cabinent shelves	pegs for cabinet shelves
20 amps cros hinghs breaker	20 amps cross highs breaker
Electic Lawn Mowers	Electric Lawn Mowers
10 condiut pvc	10 conduit pvc
24 inch vessal tops	24 inch vessel tops
security camaras	security cameras
black and decker timmer parts st4500	black and decker trimmer parts st4500
balwind double cilynder lock	baldwin double cylinder lock
wire dstaples	wire staples
frigidare microwave	frigidaire microwave
huricane panel caps	hurricane panel caps
frameless shoer doors	frameless shower doors
riobi shop vac filter	ryobi shop vac filter
20x8 storge shed	20 x 8 storage shed
rigid compound miter saw dust pouch	ridgid compound miter saw dust pouch
eletric water heater	electric water heater
24 sydey collection	24 sydney collection
pvd electrical conduit	pvc electrical conduit
light bulb 250 cfl	light bulb 250w cfl
dog ,cat,repellant	dog ,cat,repellent
wax ring with self taping bolts	wax ring with self tapping bolts
backyard xs capes	backyard xscapes
andersor doors	anderson doors
woodrx ultra natural	wood rx ultra natural
heavy dutty garden hose	heavy duty garden hose
all in one topmount kraus sinks	all in one top mount kraus sinks
whirlpool gasnstove self cleaning oven	whirlpool gas stove self cleaning oven
wall mount outside motion dector	wall mount outdoor motion detector
drop cieling tiles 2ft by 4 ft	drop ceiling tiles 2ft by 4ft
3m 60926 vapor catridges	3m 60926 vapor cartridges
maytab bravos	maytag bravos
wood swimg set kits	wood swing set kits
replacment stove knobs	replacement stove knobs
g e micewave	g e microwave
light s for sno throwers	lights for snow throwers
haging wire	hanging wire
nickle vanity lighting mosaics	nickel vanity lighting mosaics
garden hose repir cuplings	garden hose repair couplings
rock wall papper	rock wallpaper
3 1/2 hardwar	3 1/2 hardware
navarra sierra passage doorknob set	navarra sierra passage door knob set
galvanisedround fire pit ring	galvanized round fire pit ring
1/2' plyweood	1/2' plywood
bathroom  pedelal sink	bathroom pedestal sink
grill ousite door	grill outside door
klien folding 6ft ruler	klein folding 6ft ruler
rectangular baulaster	rectangular baluster
adheasive	adhesive
flourescent tube	fluorescent tube
peir mount black	pier mount black
luever	leuver
enfineered floors drifting sand	engineered floors drifting sand
glacier bay  shower catridge	glacier bay shower cartridge
homeywell cool moisture humidifier filters	honeywell cool moisture humidifier filters
round plastic  tablrs	round plastic tables
pnematic flooring nails 16 gauge	pneumatic flooring nailer 16 gauge
hydraulic jack renat	hydraulic jack rental
no burn spry	no burn spray
proclean concentrated drain cleaner	pro clean concentrated drain cleaner
ge just cut fraiser fur	ge just cut fraser fir
acess panel	access panel
lectric string trimmer cst1200r	electric string trimmer cst1200r
acrilic white paint	acrylic white paint
mial boxes	mail boxes
dustless ginder	dustless grinder
patternn paint rollers	pattern paint rollers
concrete sonic tub	concrete sonic tube
conner trim moulding	corner trim moulding
recesse light bulbs	recessed light bulbs
shop vacumm	shop vacuum
sheetrock high preformance joint compound	sheetrock high performance joint compound
powermate  walkbehind trimmer	powermate walk behind trimmer
huskie air compressors accessories	husky air compressors accessories
6 ft laminite countertop	6 ft laminate countertop
wainscoating	wainscoting
drywall fastner	drywall fastener
continuos curtain rods	continuous curtain rods
porcelin tile black pencil tile	porcelain tile black pencil tile
diverter handels	diverter handles
brinkman grill burner	brinkmann grill burner
16x26 recesssed medicine cabinets	16x26 recessed medicine cabinets
12x12 tile msaic	12x12 tile mosaic
Insulted work gloves	Insulated work gloves
front load fridaire	front load frigidaire
5/4 lumbe	5/4 lumber
sliding tub soors	sliding tub doors
milwaukee skill saw	milwaukee skil saw
wireing	wiring
ghroe shower headstrong shower heads	grohe shower headstrong shower heads
ceiling mounted lighting fixures	ceiling mounted lighting fixtures
surface mount channe	surface mount channel
backsplach	backsplash
drain spoutts	drain spouts
tempered glass wndow	tempered glass window
flexiblr bit	flexible bit
shelter logic sun sahde	shelterlogic sun shade
stone outside tile	stone outdoor tile
10/4 SJ CABLE	10/4 SJO CABLE
rustolium paint american accesnts	rustoleum paint american accents
thermadore black cast kitchen sink	thermador black cast kitchen sink
rehargeable aa batteries for landscape lighting	rechargeable aa batteries for landscape lighting
metal  urathane	metal urethane
1 1/2 couplingg	1 1/2 coupling
bifold door hardw	bifold door hardware
serface mount medicine cabinets	surface mount medicine cabinets
concete placer	concrete placer
r25/r30 faced insullation	r25/r30 faced insulation
hindged l bracket	hinged l bracket
air compresser	air compressor
kitchaid 3 burner	kitchenaid 3 burner
vinal flooring 25 year warranty	vinyl flooring 25 year warranty
storage shelfs	storage shelves
heat only therostats	heat only thermostats
potable air conditioners	portable air conditioners
marine grade painr	marine grade paint
hampden bay chandelier	hampton bay chandelier
wall beveled framelessmirror	wall beveled frameless mirror
hunter ceiling fans accesories strip	hunter ceiling fans accessories strip
metal fence postsd	metal fence posts
milwalke brewers garden flag	milwaukee brewers garden flag
16x7 garage door sandtone	16x7 garage door sandstone
propane gas tank meater	propane gas tank meter
4in drain gratewhite	4in drain grate white
lockbox keydoor lock	lockbox key door lock
moehn kitchen facet 87211srssd	moen kitchen faucet 87211srs
miracle grow water absorbing crystals	miracle gro water absorbing crystals
plastix box	plastic box
wine coller	wine cooler
shampoo and lotion automatice dispenser	shampoo and lotion automatic dispenser
wireless light sitch	wireless light switch
5000 lumnes	5000 lumens
ceramic tile  tooth brush and  soap holder	ceramic tile toothbrush and soap holder
replacement delta faucet cartrigdge	replacement delta faucet cartridge
high output floresant	high output fluorescent
faucet pl801l 18 guage	faucet pl801l 18 gauge
varbide 7 1/4 circular saw blade	carbide 7 1/4 circular saw blade
closermaid cabinet	closetmaid cabinet
askley electric  fireplace	ashley electric fireplace
loadspeaker	loudspeaker
makita oscilating saw	makita oscillating saw
plastic organozers	plastic organizers
fanc wire	fancy wire
window tintinig	window tinting
co2 detector kiddie	co2 detector kidde
16 aluminuim ladder	16 aluminum ladder
redi ledge cooner	redi ledge corner
adirondac, patio chair	adirondack, patio chair
10 stair lader	10 stair ladder
100 gallon storage ben	100 gallon storage bin
swivle fitting for gas	swivel fitting for gas
prelit spiral trees	pre lit spiral trees
front doors - poinye zinc	front doors - pointe zinc
2x4x10 pressure treater	2x4x10 pressure treated
generaor for fridge	generator for fridge
anderson windows	andersen windows
High Wheel String Trimer	High Wheel String Trimmer
3 function double walll switch	3 function double wall switch
ego   hainsaw	ego chainsaw
window drip egedg	window drip edge
hand heald showers and ada grab bars	hand held showers and ada grab bars
champion toliet part	champion toilet parts
laundry bnasket	laundry basket
shitch cover	switch cover
lampost motion detector	lamp post motion detector
dual switch dimer	dual switch dimmer
paint storage contaiers	paint storage containers
montagna dappy gray	montagna dapple gray
vinal blind paint	vinyl blind paint
hampton bay geogian wall plates aged bronze	hampton bay georgian wall plates aged bronze
floo shets	floor sheets
600w incandecent toggle dimmer	600w incandescent toggle dimmer
celing fan 60	ceiling fan 60
bulk calking	bulk caulking
shutter screwws	shutter screws
sliding reversable patio door	sliding reversible patio door
scounces wall light outside	sconces wall light outside
master flow insolated duct wrap	master flow insulated duct wrap
HEATED TOLIET SEAT	HEATED TOILET SEAT
treaated plywood	treated plywood
real live orchred plants	real live orchid plants
post insurts	post inserts
frost protectionm	frost protection
moen single handle valvue rebuild	moen single handle valve rebuild
flexable 6 inch	flexible 6 inch
lineulium floor	linoleum floor
standing seam roof panals	standing seam roof panels
simpon strong tie wedge	simpson strong tie wedge
kitcheen door blind	kitchen door blind
post light bulbl	post light bulb
grey rubbermaid trash barrells	grey rubbermaid trash barrels
unfinished wood p-lant stand	unfinished wood plant stand
f15 t5 florescent	f15 t5 fluorescent
behr premium plus ultrta	behr premium plus ultra
water pic shower head chrome	waterpik shower head chrome
hidraulic tools	hydraulic tools
picinic tables	picnic tables
9'  plna replament blade	9' plane replacement blade
prelit tree mutli	pre lit tree multi
ciling pan	ceiling pan
mess wire fencing	mesh wire fencing
portable aircondition	portable air conditioner
sower cleaner	shower cleaner
soild 6 panel interior door	solid 6 panel interior door
slidein range bisque	slide in range bisque
patio chair cusions	patio chair cushions
water softner	water softener
safegaurd 30 synthetic felt	safeguard 30 synthetic felt
cyprees fence	cypress fence
koehler cimarron bathroom sink	kohler cimarron bathroom sink
infred turkey fryer	infrared turkey fryer
garge door handle	garage door handle
schlade wirell door lock	schlage wireless door lock
airfilter 20x24	air filter 20x24
outlet wallplate with cover	outlet wall plate with cover
chesapeke nightstand in cherry	chesapeake nightstand in cherry
faux diamondplate	faux diamond plate
engeenered wood	engineered wood
montagnia contina floor tile	montagna cortina floor tile
bronze outdoor ceiling dan	bronze outdoor ceiling fan
1 1/2 colated rock screws	1 1/2 collated rock screws
outdoor vertical sheda	outdoor vertical sheds
decorative  clarance	decorative clarence
samsung 25.6 french door refridgerator	samsung 25.6 french door refrigerator
bankoft toilet biscuit	bancroft toilet biscuit
electric detector in simming pool water	electric detector in swimming pool water
kitchen aid refrigirator light bulb:	kitchenaid refrigerator light bulb:
negitave air machine	negative air machine
delata raincan	delta raincan
yelloe safet tape	yellow safety tape
leviton - decora 3 gang midway nylon wall plate - light almo	leviton - decora 3 gang midway nylon wall plate - light almond
centipe grass seed	centipede grass seed
american standard town square widespread facet	american standard town square widespread faucet
robi battery lawn trimmer	ryobi battery lawn trimmer
3 butto pico pj-3b	3 button pico pj-3b
potable firepace	portable fireplace
glass tile backsp gpxtpnrf	glass tile backsp gpx pnrf
square buckes	square buckets
rectangele garbage can	rectangle garbage can
l tub fauctes	l tub faucets
outlet expsnsion surge protector	outlet expansion surge protector
white glossy furniture pain	white gloss furniture paint
ridged 1 emt conduit	rigid 1 emt conduit
bath tub shower repair lit	bathtub shower repair kit
ac cooling fin straightenrs	ac cooling fin straightener
american-standarfairfield elongated one-piece 1.6 gpf toilet	american-standard fairfield elongated one-piece 1.6 gpf toilet
t post fence assesories	t post fence accessories
energy efficent skylight	energy efficient skylight
mout faucet water filter	mount faucet water filter
milwaukee noncontact tester	milwaukee non contact tester
outdoorstorage bin	outdoor storage bin
pcv coated hardware cloth	pvc coated hardware cloth
dewalt ratchet srewdriver	dewalt ratchet screwdriver
dreamline showeruni door	dreamline shower door
black cobwoys star	black cowboys star
centerpise	centerprise
greem roofing shingles	green roofing shingles
copper baluseter	copper baluster
wood ballusters	wood balusters
23 ince	23 inch
warm espresso distresed	warm espresso distressed
dental shelf door	dentil shelf door
plexiglass selves	plexiglass shelves
pcv pipe sement	pvc pipe cement
scoaring pads	scouring pads
ypermethrin	cypermethrin
asb shower  with curtian	asb shower with curtain
water softners	water softeners
on off valvefor tub faucet	on off valve for tub faucet
bateries	batteries
roybi pop up	ryobi pop up
soil temperture test kit	soil temperature test kit
ceiling medallians	ceiling medallions
squar flushmount lights	square flush mount lights
tamper resistant combo outet black	tamper resistant combo outlet black
cover kage for pet	cover page for pet
hoinda gas edger	honda gas edger
rigid shop vac filter	ridgid shop vac filter
bath si k cabinets	bath sink cabinets
30 gar builtin ranges	30 gas built in ranges
extirior clear spray paint	exterior clear spray paint
gardinias	gardenias
1/4-20 jamb nuts	1/4-20 jam nuts
roof pannel foam	roof panel foam
summit gril	summit grill
round lshower kit	round shower kit
Schecule 40 Pipe	Schedule 40 Pipe
foundation fent covers	foundation vent covers
large outside horizontal storage shed	large outdoor horizontal storage shed
long shower curtins	long shower curtains
led ressed deameable lights	led recessed dimmable lights
masonary dril bits	masonry drill bits
gble vent	gable vent
the  govenore	the governor
closet doors oganizers	closet doors organizers
pet disinfectent	pet disinfectant
ac exhaust extention	ac exhaust extension
shower wal hook	shower wall hook
t8 flourescent bulbs 4 ft 2 pack	t8 fluorescent bulbs 4 ft 2 pack
36  curved showered curtain rod	36 curved shower curtain rod
floor mount lawndry seek	floor mount laundry sink
showe heads in oil rubbed bronze	shower heads in oil rubbed bronze
foldin g patio doors	folding patio doors
frigidare gas range	frigidaire gas range
makita skill saw	makita skil saw
black and deckerbattery pack	black and decker battery pack
under cabinet black flourescent	under cabinet black fluorescent
sheet stock floorinh	sheet stock flooring
eyebolt brass	eye bolt brass
kohler ch730 maintance kits	kohler ch730 maintenance kits
briggsstraton 11 horse air filter	briggs stratton 11 horse air filter
vynal repalcement windows	vinyl replacement windows
wrought iuron fence panels	wrought iron fence panels
pegasus antique black side spalsh	pegasus antique black side splash
cararra marble	carrara marble
desoldering vacum pump	desoldering vacuum pump
medicine cabinets recessable black	medicine cabinets recessed black
insided house door	inside house door
LAWN LEAF VACUM	LAWN LEAF VACUUM
braSS pie fittings	braSS pipe fittings
rope chritsmas lights	rope christmas lights
verticle blind	vertical blind
hing pin door dtop	hinge pin door stop
rug ruunners	rug runners
tan unmbrella	tan umbrella
robyi	ryobi
syllicone lube	silicone lube
microwarve cart	microwave cart
scrool lever	scroll lever
commercil threshold	commercial threshold
weelbarrow	wheelbarrow
rough limber	rough lumber
freplace gloves	fireplace gloves
defusiers for floors	diffusers for floors
furnance vent delfector	furnace vent deflector
oppeuss light trim ring	oppeus light trim ring
vynal siding insol	vinyl siding insol
convction heater	convection heater
vinal fencing	vinyl fencing
parquee flooring	parquet flooring
extention ladder little gaint	extension ladder little giant
ceiling pannel	ceiling panel
pull out drw	pull out draw
mke m12 heated hoddie kit	mke m12 heated hoodie kit
rood rake	roof rake
chargril grill	charbroil grill
wirerless light switch	wireless light switch
hampton bay out door celing fan	hampton bay outdoor ceiling fan
asphault gap repair	asphalt gap repair
arbourist safety climbing belt	arborist safety climbing belt
martha stewart metalic paint gallon	martha stewart metallic paint gallon
moen bronze low arch faucet	moen bronze low arc faucet
8x96 white decrotive shelf	8x96 white decorative shelf
4x8 plywood pressure treeted	4x8 plywood pressure treated
toilet aquaia	toilet aquia
replacement glass for pellet stive	replacement glass for pellet stove
water mainfold	water manifold
lihonia 4 led work light	lithonia 4 led work light
fall supression kit	fall suppression kit
air temperture contorl valve	air temperature control valve
wetbar sink and faucet	wet bar sink and faucet
weatherproof boom box	waterproof boombox
square bannister	square banister
whirlpool lgas dryer	whirlpool gas dryer
fungacide	fungicide
composote lumber	composite lumber
craftig pvc cabinets	crafting pvc cabinets
30 amp surface mount recepticle	30 amp surface mount receptacle
min fridges for campers	mini fridges for campers
thickrubber mat	thick rubber mat
american atanderd plebe 4086	american standard plebe 4086
liqwuid nail	liquid nail
1/2 inc pvc treaded connector	1/2 inch pvc threaded connector
latge storage containers	large storage containers
12' firetreat 2x4	12' fire treated 2x4
110 air conditior an heat	110 air conditioner and heat
kohler top mont bathroom  sink	kohler top mount bathroom sink
table glass oatu	table glass oahu
deck tdiles	deck tiles
outdoor furniture cover martha steward	outdoor furniture cover martha stewart
kitchenover sink lighting	kitchen over sink lighting
makersbot	makerbot
whirpool microwave 1.4 cu ft	whirlpool microwave 1.4 cu ft
elecronic insect repeller	electronic insect repeller
water resistent top	water resistant top
non ferroue saw blade	non ferrous saw blade
upholstry	upholstery
heavy duty polyurathane	heavy duty polyurethane
10  roll up outside blinds	10 roll up outdoor blinds
natural stone tiele	natural stone tile
interlocking rubbber floor mats	interlocking rubber floor mats
milwaukee cordlees tools	milwaukee cordless tools
emparador mosaic bamboo brick	emperador mosaic bamboo brick
barn syslet door	barn style door
fiberglass repir kit	fiberglass repair kit
swamp  oolers	swamp coolers
4ft flourescent bulb t8	4ft fluorescent bulb t8
wiemans stainless cleaner	weimans stainless cleaner
hardwoo flooring 2 1/4 in	hardwood flooring 2 1/4 in
i beam brackest	i beam brackets
wall socket covedrs	wall socket covers
boshe double bevel sliding miter saw	bosch double bevel sliding miter saw
whirpool 7000 washer	whirlpool 7000 washer
no elecetrity lights	no electricity lights
28x80 contl splt rh	28x80 control split rh
3 newll post	3 newel post
monococcon 8x8 ceramic azuvi tile	monococcion 8x8 ceramic azuvi tile
golith	goliath
cabibet shelf pins	cabinet shelf pins
96 in flourescent bulbs	96 in fluorescent bulbs
8' sigle wall gal pipe	8' single wall galv pipe
metal flexable water hose	metal flexible water hose
kitchen aid architecs series 11	kitchenaid architect series 11
plaqstic bucket	plastic bucket
virtue usa huntshire	virtu usa huntshire
whirpool gas range	whirlpool gas range
atlantiic can racks	atlantic can racks
patio chair cushions/marth stewart	patio chair cushions/martha stewart
brushed nichol hanging lights	brushed nickel hanging lights
whilrpool front loader washer	whirlpool front loader washer
repacement can type light bulbs	replacement can type light bulbs
blown in insulaation	blown in insulation
sharkbike push to connect 3/4	sharkbite push to connect 3/4
sailr blue	sailor blue
toilet repair kit cadet 3 flowise 2-piece 1.28 gpf round fro	toilet repair kit cadet 3 flowise 2-piece 1.28 gpf round front
93 inch widecellular shades	93 inch wide cellular shades
waxhers and electric dryers	washers and electric dryers
gibraltor locking	gibraltar locking
t8 8 ft 4-light flourescent fixture	t8 8 ft 4-light fluorescent fixture
led shoplightmakita light	led shop light makita light
closetmade wood	closetmaid wood
bed frames headboaed	bed frames headboard
crub rubber	crumb rubber
white melimine cabinet	white melamine cabinet
wirless interconnected smoke dedector	wireless interconnected smoke detector
toilet seat for briggs toliet	toilet seat for briggs toilet
blitz colth	blitz cloth
guarter round tile	quarter round tile
6 dewalt skill saw	6 dewalt skil saw
tall wine cabnet	tall wine cabinet
glass cleaner concintrete	glass cleaner concentrate
laquer thinner	lacquer thinner
counter refinsher	counter refinishing
solar post l8ghts	solar post lights
stainstess steel spray paint	stainless steel spray paint
dig irritation drip	dig irrigation drip
asphaul based coating	asphalt based coating
rubbermaid resin storage cabnetsn	rubbermaid resin storage cabinets
underhood range fan	under hood range fan
window aircondiioner 12000 but	window air conditioner 12000 btu
gagarage storage cabinets	garage storage cabinets
heat on malamine tape	heat on melamine tape
bathroom floting ball	bathroom floating ball
garage shelve	garage shelf
ortho weed be gone	ortho weed b gon
prebent aluminum facia	prebent aluminum fascia
eletric stove	electric stove
badless vacuum cleaners	bagless vacuum cleaners
desalt impact 18	dewalt impact 18
kitchen aid processer	kitchenaid processor
husky work bemch	husky work bench
magniflier lamp	magnifier lamp
peir block	pier block
lawn grass catchbag	lawn grass catcher bag
ornge 5x7 rugs	orange 5x7 rugs
shop swiming pools	shop swimming pools
long brakets	long brackets
schlage handleset bermingham	schlage handleset birmingham
non electically conductive epoxy	non electrically conductive epoxy
boscj bit	bosch bit
outdoor seatting cushions	outdoor seating cushions
solar out doors post lights	solar outdoor post lights
delta satin nickle shower systems	delta satin nickel shower systems
hecurles	hercules
topdown bottom up shades	top down bottom up shades
door chim buttons	door chime buttons
24x24 framless recessed mount mirrored medicine	24x24 frameless recessed mount mirrored medicine
faun paint	fawn paint
sheeet rock mud	sheetrock mud
garden pond pump impellor	garden pond pump impeller
electric radiatior heat	electric radiator heat
1x8x8 toung and grove	1x8x8 tongue and groove
zinc plated flatbraces	zinc plated flat braces
johan deer 0 turns	john deere 0 turns
all porpose stools	all purpose stools
10guage copper wire 3 stand	10 gauge copper wire 3 stand
sealant for sideing	sealant for siding
coragated aluimin special order	corrugated aluminum special order
lawn mowre covers	lawn mower covers
cadelabra light bulbs led	candelabra light bulbs led
didger	dodger
stell finished french patio door	steel finished french patio door
is this item in stoes?	is this item in store?
batterys and charger kits	batteries and charger kits
lg ruff wall instalation	lg ruff wall installation
dcanvas drop cloth	canvas drop cloth
sheeking  for log cabin	seeking for log cabin
greecianmarble floor tile	grecian marble floor tile
linoliuml adhesive	linoleum adhesive
mown pull down faucet	moen pull down faucet
tool package with pilers,needlenose	tool package with pliers,needlenose
trimmer/edger's, gas powered	trimmer/edgers, gas powered
cieling fan	ceiling fan
cornewr bathtub	corner bathtub
ultra clarifer, pool	ultra clarifier, pool
phillips exterior led	philips exterior led
bear paint green myth	behr paint green myth
48x48 windoww	48x48 window
14 awgsoilid wire	14 awg solid wire
eagle peak hoickory	eagle peak hickory
linen storage cabnit	linen storage cabinet
roffing caulk	roofing caulk
assie grill fire and ash	aussie grill fire and ash
kaorik wine	kalorik wine
allure vinyl tilecordoba	allure vinyl tile cordoba
plug in led night lite photocell	plug in led night light photocell
aromaticeatern red cedar planking	aromatic eastern red cedar planking
home sevalance cameras	home surveillance cameras
pink toliet seat elongated	pink toilet seat elongated
econo florecent bulb	econo fluorescent bulb
melamine shelvees	melamine shelves
spray metallicpaint	spray metallic paint
2-handlet diverter repair kit	2-handle diverter repair kit
deck post jhardware	deck post hardware
owens corning ashingles	owens corning shingles
primeline mirror sliding doors	prime line mirror sliding doors
1 amp receptical	1 amp receptacle
blue tapeexhaust fan/light	blue tape exhaust fan/light
25 watt 4 foot flourescent	25 watt 4 foot fluorescent
mini pendant braket	mini pendant bracket
2x6 treted  8ft long	2x6 treated 8ft long
ourdoor patio tile	outdoor patio tile
defiant led ight	defiant led light
hdx 20' hight velocity floor fan	hdx 20' high velocity floor fan
doors gaurds	doors guards
accordian door venetian	accordion door venetian
oil rubbed bronze airgap for dishwasher	oil rubbed bronze air gap for dishwasher
ant bait raps	ant bait traps
rasin raised garden bed	resin raised garden bed
carrrs	careers
1/4 qk connect x 1/8 mip	1/4 quick connect x 1/8 mip
honewell wireless doorbell	honeywell wireless doorbell
cabrio dryder	cabrio dryer
bath sinnk	bath sink
high intensity t5 flourescent lights	high intensity t5 fluorescent lights
mirror, brushed nichel	mirror, brushed nickel
murry circuit breakers 20 amps	murray circuit breakers 20 amps
daylillies	daylilies
vinal fence straps	vinyl fence straps
lifetime rouind table	lifetime round table
gladden smooth stone	glidden smooth stone
52' pinacle ceiling fan	52' pinnacle ceiling fan
cement mason bit	cement masonry bit
air condtioning wall unit	air conditioning wall unit
oil rubbed bronse bathroom lighting	oil rubbed bronze bathroom lighting
delta bathroom falcet	delta bathroom faucet
fram boxes	frame boxes
ge microwave wall oven comb	ge microwave wall oven combo
gas stabilisor	gas stabilizer
dewalt hand toolsg saw cordless	dewalt hand tools saw cordless
hole house fan	whole house fan
shigles	shingles
metal lath stuko	metal lath stucco
woodceramic floor tile	wood ceramic floor tile
10 window sping rod	10 window spring rod
solar light rechargable batteries	solar light rechargeable batteries
mission prarie camber top slab	mission prairie camber top slab
GRAGE DOOR OPENER	GARAGE DOOR OPENER
bostic wood floor glue	bostik wood floor glue
fire extinguishhers	fire extinguishers
alumium fence 6 ft 6ft	aluminum fence 6 ft 6 ft
zurn hot short stemcartridge	zurn hot short stem cartridge
brinly hardy 40 inc tow behind	brinly hardy 40 inch tow behind
vynil floorring	vinyl flooring
tile slide cuter	tile slide cutter
plywood progect	plywood project
motion lught	motion light
core aeretor	core aerator
burgular bars for front porch	burglar bars for front porch
oaint marker	paint marker
bq heat distributipn plates	bbq heat distribution plates
hampton bay cabinetscornor cabinetupper	hampton bay cabinets corner cabinet upper
fabreeze	febreze
under cabinet lighting ro-hs	under cabinet lighting rohs
hot point water filer	hotpoint water filter
mikita 18v 2.6 ah	makita 18v 2.6 ah
Huskavarna	Husqvarna
flourescent shop light	fluorescent shop light
kolher	kohler
nailer  tooal	nailer tool
garden sprayer non pump	garden sprayer no pump
glacier bay tiolet tank lid	glacier bay toilet tank lid
fernace vent shut off	furnace vent shut off
blind courner	blind corner
bosss water softner	boss water softener
exterior vanyl french door	exterior vinyl french door
outside horizontal storage sheds	outdoor horizontal storage sheds
rigid air compressor	ridgid air compressor
rollup door	roll up door
milluakee drill bits	milwaukee drill bits
storage shelve	storage shelf
bathroom faucet replacment valve	bathroom faucet replacement valve
22 storage shelve	22 storage shelf
through thewall air conditioner	through the wall air conditioner
outdoord storage locker	outdoor storage locker
sharkbit	sharkbite
powerwasher hose	power washer hose
plastice corrugated panels	plastic corrugated panels
hardi  board smooth	hardie board smooth
elictric door bail	electric door bell
gekko gauges	gecko gauges
pecane trees	pecan trees
dowel sprial	dowel spiral
vertical binds hardware	vertical blinds hardware
2in non metalic standing coupling	2in non metallic standing coupling
bulked washed sand and gravel	bulk washed sand and gravel
insect granuels	insect granules
hunter new bronzel fans	hunter new bronze fans
cedart board	cedar board
flourescent g25 60watt	fluorescent g25 60 watt
golden krome spray	gold chrome spray
Moen Kitchen sink fauset	Moen Kitchen sink faucet
11 1/2x25 1/2 white aluminun	11 1/2 x 25 1/2 white aluminum
genecrac generators	generac generators
ge profile 30 inch charcoal folters	ge profile 30 inch charcoal filters
squeege	squeegee
sheet meatal hole cutter	sheet metal hole cutter
lock cmbo	lock combo
howard restore a finish	howard restor a finish
altra furniture parsons credenza desk with drawer and bookc	altra furniture parsons credenza desk with drawer and books
terracotta exteriorpaint	terracotta exterior paint
oval steele tubs	oval steel tubs
saratoga hickorya	saratoga hickory
wood sculture tool	wood sculpture tool
toile seat lid	toilet seat lid
rust oleam pinters touch black	rust oleum painters touch black
starter fuil	starter fuel
cemnt pads for makita bo5030	cement pads for makita bo5030
mosaic esterior	mosaic exterior
multi plub adapter	multi plug adapter
drywal	drywall
dewalt jig saw blad	dewalt jig saw blade
air conditioner vbration	air conditioner vibration
cree led bub 6-pack	cree led bulb 6-pack
river feather door threashold	river feather door threshold
cop mail adapter	cop male adapter
kwiksest door handle delta	kwikset door handle delta
dimmable fluoreecent	dimmable fluorescent
concerte stair railings	concrete stair railings
mnt movr combo shovel	mnt move combo shovel
infloor heating antifreeze	in floor heating antifreeze
buit in shower base	built in shower base
aluminium tube rectangle	aluminium tube rectangular
ho hub couplings	no hub couplings
landscasping ms international polish black stone	landscaping ms international polish black stone
entery door sidelights	entry door sidelights
85 gall tall 4500	85 gal tall 4500
spring heavy dut	spring heavy duty
utility traiter	utility trailer
dinning tables	dining tables
scroll saw spirsl blade	scroll saw spiral blade
kitchenmaid built-in double drawer	kitchenaid built-in double drawer
5/8-in masonary drill bit	5/8-in masonry drill bit
swffer mop	swiffer mop
el ctrical s ez	electrical sez
600 connector cylander	600 connector cylinder
fraiming nailer electric	framing nailer electric
habor gazeebo	harbor gazebo
lg elec laundry suite	lg electric laundry suite
sola water fountain	solar water fountain
led  light bulbsbulbs	led light bulbs bulbs
4 ftawning frame	4 ft awning frame
three wayy	three way
electic chainsaw worx	electric chainsaw worx
hampton bay jmestown	hampton bay jamestown
famed sliding door $289.00	framed sliding door $289.00
wall panaling	wall paneling
thin set fray	thin set gray
christmass  lights	christmas lights
bathroom lightning 48 inch	bathroom lighting 48 inch
solar pest repelers	solar pest repellers
14 ft. w x29 ft. l x 14 ft.h	14 ft. w x 29 ft. x 14 ft.h
3/8 couipling	3/8 coupling
fi nish screws	finish screws
paint colores by rooms	paint colors by rooms
remove oder from kerosine	remove odor from kerosene
whirpool amana	whirlpool amana
hot water heating eliment	hot water heating element
2' x 1 1/2 reducing busing thread	2' x 1 1/2 reducing bushing threaded
oli rubbed bronze drain	oil rubbed bronze drain
qucikie mop	quickie mop
celing fans with lighting and remote	ceiling fans with lighting and remote
battery operated flashingm light	battery operated flashing light
hot dipped galvanized screwes	hot dipped galvanized screws
3 sewer pipce	3 sewer pipe
gas black range worldpool	gas black range whirlpool
white wall  bathroon cabinets	white wall bathroom cabinets
charley brown christmas trees	charlie brown christmas trees
merola porcelain mosiac	merola porcelain mosaic
contracto0r hose	contractor hose
gcfi outlet	gfci outlet
daltiles sandy beach	daltile sandy beach
martha steward	martha stewart
huskey scocket set	husky socket set
branch protctor paint	branch protector paint
grass string trimmer electric homelight	grass string trimmer electric homelite
kohler pedestal sink cimeron	kohler pedestal sink cimarron
soap punp	soap pump
hampton bay reswood valley 5 pc patio seating set with fire	hampton bay redwood valley 5 pc patio seating set with fire
bed tool boc	bed tool box
vegetable plannter	vegetable planter
14 electric concrete saw with vc-u dch300	14 electric concrete saw with vac-u dch 300
indoor infered heaters	indoor infrared heaters
1/2 inch pnumatic stapler	1/2 inch pneumatic stapler
range connnector	range connector
refrigerator frenchdoor	refrigerator french door
vesel tub	vessel tub
22 mm impact ocket	22mm impact socket
collor clamp	collar clamp
glass washer with sucktion cups	glass washer with suction cups
presure coated wood	pressure coated wood
three wire hottube	three wire hot tub
fiber glass pip insulation	fiberglass pipe insulation
cabinents with drawers	cabinets with drawers
pvc drop in celing tiles	pvc drop in ceiling tiles
extertal air vent  cover	external air vent cover
taylor test lit	taylor test kit
18 wat let lamps	18 watt led lamps
40 airens mulching kit	40 ariens mulching kit
stainless steeel collated nails	stainless steel collated nails
14heightx24withx15depth air conditioner	14 heightx24 with 15 depth air conditioner
arc fault circute breaker 1pole 15 amp	arc fault circuit breaker 1 pole 15 amp
anderson french wood patio door 400 series	andersen frenchwood patio door 400 series
securty bar mounts	security bar mounts
ceiling fan replacement clades	ceiling fan replacement blades
dleta shower faucet handles	delta shower faucet handles
birkmann 5 burner	brinkmann 5 burner
closetmade	closetmaid
2 in lnsulated bushings	2 in insulated bushings
safavieh courtyard dark biege area rug	safavieh courtyard dark beige area rug
flurorescent   light bulbs	fluorescent light bulbs
mobil home glass door	mobile home glass door
he xl 44 range	ge xl44 range
phillips led slimline a19	philips led slimline a19
kitchen sink and fawcet black dual mount	kitchen sink and faucet black dual mount
3m winow film	3m window film
halh circle glass shelf	half circle glass shelf
motion detect indoor	motion detector indoor
roll up door fo shed	roll up door for shed
glaciar bay toiled	glacier bay toilet
outdoor chritstmas light remote	outdoor christmas light remote
range hoodu	range hood
elctric heating lamps	electric heating lamps
rumbl;estone	rumblestone
thresh hold	threshold
electric pump for sprying	electric pump for spraying
kliz primers	kilz primers
clear corrougated sheets	clear corrugated sheets
10 yeaer smoke detectors/carbon monoxide combo	10 year smoke detectors/carbon monoxide combo
interior walls bieges brown	interior walls beige brown
coper clad aluminum	copper clad aluminum
ryobi one batery	ryobi one battery
keorsene heater wicks	kerosene heater wicks
quickcrete waterproof cement	quikrete waterproof cement
lasron slider windows	larson slider windows
contrcator baseboard	contractor baseboard
1-1/4 pocket hole screwsw	1-1/4 pocket hole screws
ligth	light
58.75x80 sliding glass door	58.75x 80 sliding glass door
havc brush	hvac brush
hardward for pull out waste bin	hardware for pull out waste bin
soap wash maching tilde	soap wash machine tilde
alltyp of fences	all type of fences
dewalt empact driver	dewalt impact driver
wead burner	weed burner
whilrpool cabrio dryer	whirlpool cabrio dryer
min split mounting brackets	mini split mounting brackets
clear vlyvynal an rolls	clear polyvinyl and rolls
tub suround	tub surround
infared grills	infrared grills
caroilne avenue 36 in single vanity in white marble top in l	caroline avenue 36 in single vanity in white marble top in l
vegtable seeds	vegetable seeds
5plinth block	plinth block
hand pipe theader	hand pipe threader
sanora maple flooring	sonora maple flooring
7' 90 elboq	7' 90 elbow
seet metal tools	sheet metal tools
moen voss lightin	moen voss lighting
copact drills cordless	compact drills cordless
lock tight pl	loctite pl
water fountain nozle	water fountain nozzle
sharkbite sprinler	sharkbite sprinkler
counter depth refridgidere	counter depth refrigerator
20' facia board	20' fascia board
koehler shower door	kohler shower door
2 sheet metal screrw	2 sheet metal screw
12 foot ceadar	12 foot cedar
kholerhighland white toilet	kohler highline white toilet
minala rope	manila rope
charbroil parts	char broil parts
wood fuelpellets	wood fuel pellets
dewaqlt air nailers	dewalt air nailers
manual for airens lawnmower	manual for ariens lawn mower
galvanized outdoor celing fan	galvanized outdoor ceiling fan
dill battery 12v model g0805	drill battery 12v model g0805
ceiling fan canopie for flst ceiling	ceiling fan canopy for flat ceiling
pressure guage	pressure gauge
electric barbeque grills	electric barbecue grills
fridigdaire back gas range	frigidaire black gas range
sanding beltsr	sanding belts
primer for led paint	primer for lead paint
chase lounge cushions	chaise lounge cushions
decrotive metal deck rail incecerts	decorative metal deck rail inserts
cedar wood balisters	cedar wood balusters
workstar cordless and recharable work light	workstar cordless and rechargeable work light
weed trimer push type	weed trimmer push type
spray and forget house nad deck	spray and forget house and deck
extenion cord storage	extension cord storage
floor squeege	floor squeegee
36 exterior steele door	36 exterior steel door
1-1/4 extention pvc	1-1/4 extension pvc
4 x 4 white pocelain tile	4 x 4 white porcelain tile
heavy dutty letter support	heavy duty letter support
daltile hexgon	daltile hexagon
sqaure vessel sink	square vessel sink
chesapeke oak flooring	chesapeake oak flooring
phenofin	penofin
CHASE LOUNGE	CHAISE LOUNGE
sconses	sconces
heavy duty shevlving	heavy duty shelving
tile border black and whit	tile border black and white
under ceiling garag storage	under ceiling garage storage
rug pad 8 x  10	rug pad 8x10
tsnkless hot water heater	tankless hot water heater
3-3 galvinized tubing	3-3 galvanized tubing
14 in dimond circular saw blade	14 in diamond circular saw blade
cable prime line emergensy open	cable prime line emergency open
60 shower ddor	60 shower door
1/2 ' copper fiting	1/2 ' copper fitting
feather river doorsth sidelights	feather river doors sidelights
4 quck grip 101	4 quick grip 101
prefab wood gate panals	prefab wood gate panels
Renassaince	Renaissance
cabnet knobs	cabinet knobs
double deountable	double demountable
3-piece bath accessory kit in chrom	3-piece bath accessory kit in chrome
citronella fire pot fue	citronella fire pot fuel
ashely 48 in electric chi	ashley 48 in electric chi
chissel	chisel
yard fooger	yard fogger
whitesilicone	white silicone
3/8 viyl j channel	3/8 vinyl j channel
french door scree doorsscreen door	french door screen doors screen door
disposal rim and stopperkohler	disposal rim and stopper kohler
square d double brakers	square d double breakers
oped garage door indicator	open garage door indicator
airguard undelayment	airguard underlayment
marrazi	marazzi
edget tape	edge tape
nutone vaccum wall plate	nutone vacuum wall plate
plaste dip	plasti dip
barbeque insert	barbecue insert
chainlink gate	chain link gate
rount magnet	round magnet
elvies ornament	elvis ornament
cender blocks	cinder blocks
divonshire	devonshire
brick wall panles	brick wall panels
kitchen tile backspl	kitchen tile backsplash
smaller closet lights	small closet lights
tile medalions for the floor or wall	tile medallions for the floor or wall
anderson storm doors pet	andersen storm doors pet
koehler faucet	kohler faucet
hot water recirculator	hot water recirculation
whitecomposite fascia board	white composite fascia board
ryobi raidos	ryobi radios
bathroom fan motion sencer	bathroom fan motion sensor
8 valleta edger	8 valletta edger
outdoor picture ftames	outdoor picture frames
25 height beveragecooler	25 height beverage cooler
magnet stainless steel for diswasher	magnet stainless steel for dishwasher
4 in pvs end cap	4 in pvc end cap
roof rdge flashing	roof edge flashing
bath and shower facet set	bath and shower faucet set
clothsline rope	clothesline rope
arearugs and mats	area rugs and mats
outdoor spigot spliter	outdoor spigot splitter
weather strip for commerial door	weather strip for commercial door
repare kit for 2-handle side sprayer kitchen faucet	repair kit for 2-handle side sprayer kitchen faucet
bolt conrete anchors	bolt concrete anchors
mikita cordless drill	makita cordless drill
clock control for fridgidare gas stove	clock control for frigidaire gas stove
heat circualtor	heat circulator
work force prpane heatr	workforce propane heater
richman water heater	richmond water heater
wall mount tub fauet moen	wall mount tub faucet moen
pvc to corragated connector	pvc to corrugated connector
rechargable portable air compressor	rechargeable portable air compressor
wall paper  murial glue	wallpaper mural glue
irragation controler	irrigation controller
shower fllor	shower floor
hdmi cabl	hdmi cable
over ran	overran
ce tech coaxial cablenail in clips	ce tech coaxial cable nail in clips
metal scerews	metal screws
7w compact flourescent bulb	7w compact fluorescent bulb
closetmaid hang9ing shelf	closetmaid hanging shelf
rachet scret drivers	ratchet screwdrivers
allure golden oaksku579331	allure golden oak sku 579331
control celing fan	control ceiling fan
what rings for toitets	what rings for toilets
gas enthonal free	gas ethanol free
White Temper Resistant Duplex Outlet	White Tamper Resistant Duplex Outlet
wood pellats for grills	wood pellets for grills
heath zenity 180 security light	heath zenith 180 security light
rigid miter saw	ridgid miter saw
boader rocks	border rocks
toiles partes	toilet parts
backet metal	bracket metal
regancy railin	regency railing
wadrobe moving boxes	wardrobe moving boxes
banity 11 watt light bulb	vanity 11 watt light bulb
vaccumm	vacuum
lumber 2x8 composit	lumber 2x8 composite
5.0 chest freezerz	5.0 chest freezers
base board molding boundle	baseboard molding bundle
bathroom kraft made	bathroom kraftmaid
interrior frnch doors	interior french doors
price pfister  trevisa	price pfister treviso
suncort 8' duct fans	suncourt 8' duct fans
flourescent paint by rustoleum	fluorescent paint by rustoleum
electronic bed bug repellant	electronic bed bug repellent
rj45 crinp tool	rj45 crimp tool
rewiring built in oven	wiring built in oven
24 gauge wire connectorsa	24 gauge wire connectors
aluminun tread plate	aluminum tread plate
2x6 metal brakets	2x6 metal brackets
1x6 cedar boaed	1x6 cedar board
10 ft drain house	10 ft drain hose
dresser acessories	dresser accessories
treate 2x4	treated 2x4
3 gauge copper phhn	3 gauge copper thhn
restour for concrete	restore for concrete
12 bar chian for echo	12 bar chain for echo
adienne bathroom vanity light	adrienne bathroom vanity light
ridding mower covers	riding mower covers
cabinet knobsd	cabinet knobs
composit fencing	composite fencing
backsplash tiiles	backsplash tiles
mirros	mirrors
corbels and shelfs	corbels and shelves
theromometer smart	thermometer smart
fine/line baseboarrd	fine/line baseboard
digital cammera	digital camera
hand steam cleanere	hand steam cleaner
rrecessed light trim ring	recessed light trim ring
no. 30 ridgid cutting wheel	no. 30 rigid cutting wheel
exterier door keypad	exterior door keypad
retangle bathroom sinks	rectangular bathroom sinks
kitchenaid frenchdoor ref	kitchenaid french door ref
swivel saftey cover	swivel safety cover
anual combo	annual combo
progress lighting nottingdon	progress lighting nottington
touchless dishwashing kintchen dispenser	touchless dishwashing kitchen dispenser
locite 2 plus 1	loctite 2 plus 1
clothes dryer srand	clothes dryer stand
r30 demin insulation	r30 denim insulation
riobi blower vac 9056	ryobi blower vac 9056
cloths rod and shelf brackets	clothes rod and shelf brackets
anderson windows new constraction	anderson windows new construction
ryobi replacemet batteries	ryobi replacement batteries
miniture bulbs 2 pin	miniature bulbs 2 pin
vinyl lattiace	vinyl lattice
liquid bi fuels	liquid biofuels
sterling frosted glass shower ath doors	sterling frosted glass shower bath doors
closetmaid wire eight itier organizer	closetmaid wire eight tier organizer
3 light celling mount	3 light ceiling mount
standard artificial grasa synthetic lawn turf	standard artificial grass synthetic lawn turf
led fixtues for the kitchen	led fixtures for the kitchen
6 teir shelving	6 tier shelving
heat window filtm	heat window film
colonial caseing	colonial casing
glass back doorr	glass back door
black wire hidder	black wire hider
whirlpool caprios 4.3	whirlpool cabrio 4.3
toyotaa	toyota
recipricating saw 15 amp	reciprocating saw 15 amp
fork lift strps	forklift straps
sweenys mole and gopher repelant	sweeney's mole and gopher repellent
saw zall blades	sawzall blades
12 ft john boat	12ft jon boat
newtone broan round 751	nutone broan round 751
cordless celullar	cordless cellular
beer wine refrigeratr	beer wine refrigerator
dremel minimate cordless moto tool	dremel minimite cordless moto tool
window aircondition	window air conditioner
charolettetown	charlottetown
stair nose santos maogani	stair nose santos mahogany
7 mil trash bgs	7 mil trash bags
light buld for stinger zapper	light bulb for stinger zapper
kwikset halifax door leaver	kwikset halifax door lever
onda pressure washer	honda pressure washer
hagchet	hatchet
spray oil prier	spray oil primer
10000 btu windowair condiioner	10000 btu window air conditioner
tandom 30 20	tandem 30 20
12 mobil home air duct	12 mobile home air duct
ridding mowers	riding mowers
24 elicreic stove	24 electric stove
23.5 shower door nickle	23.5 shower door nickel
sliding mirror bathroom medicn cabinets	sliding mirror bathroom medicine cabinets
tarp for outsid furniture	tarp for outside furniture
small brackets for selves	small brackets for shelves
Diamond HArd Acrylic Enamal	Diamond HArd Acrylic Enamel
8 foot galvinezed	8 foot galvanized
1/2x1/2 quater round	1/2 x 1/2 quarter round
violet flourescent light	violet fluorescent light
discontinuedbrown and tan area rug	discontinued brown and tan area rug
ballast for single t12 fluorscent bulb	ballast for single t12 fluorescent bulb
vanity in mahogany  mirros	vanity in mahogany mirrors
ureka vaccuum	eureka vacuum
doors for mobilhomes	doors for mobile homes
tinted masonary sealer	tinted masonry sealer
tilebath walls small	tile bath walls small
robi 18v saw	ryobi 18v saw
adapter for extention cord	adapter for extension cord
incide wall heater	inside wall heater
attachments for zero turn  touro	attachments for zero turn toro
miricale	miracle
infrared theomomter	infrared thermometer
elerical outlets plates	electrical outlets plates
centerset 2-handle weall	centerset 2-handle wall
refrigerater french doors ge brand	refrigerator french doors ge brand
concret patio floor	concrete patio floor
PORCH STAIR RAILLING	PORCH STAIR RAILING
toro snowerblower light kit	toro snowblower light kit
solor lamp outside	solar lamp outside
wire fen c e	wire fence
milwaukie saw blades	milwaukee saw blades
shower glass slelves	shower glass shelves
vinyl flooring that clicks togther	vinyl flooring that clicks together
tub drain kit bronz	tub drain kit bronze
16x16x60boxes for moving	16x16x60 boxes for moving
preature treated lumber 2in. x12in.x12 ft.	pressure treated lumber 2in. x 12 in.x 12 ft.
brass handel door	brass handle door
fatmax leveler premier	fatmax level premier
quickcrete resurfacer	quikrete resurfacer
lattice wwod tone	lattice wood tone
dewalt drillimpact tool 20 volt xr	dewalt drill impact tool 20 volt xr
18 inch linen closit	18 inch linen closet
single knobreplacement for shower kohler	single knob replacement for shower kohler
chair rail hieght	chair rail height
legrad keystone cat5e jack	legrand keystone cat5e jack
rustolem	rustoleum
our door receptacles	outdoor receptacles
outdoor maouse traps	outdoor mouse traps
spade terminalsnylon insulated	spade terminals nylon insulated
acrtlic tape	acrylic tape
pemco sill extender	pemko sill extender
what is best for settingfence  posts in soil?	what is best for setting fence posts in soil?
vacum aa bag 58236c	vacuum aa bag 58236c
ac dip pans	ac drip pans
industreial wire	industrial wire
kholer elongated toilet seat	kohler elongated toilet seat
mirr edge	mirror edge
30 towel rods brushed nicol	30 towel rods brushed nickel
rr vaccum filter	rr vacuum filter
clorine tabs for septic	chlorine tabs for septic
broadway collectionchrome vanity fixture	broadway collection chrome vanity fixture
watherproof electrical boxes	weatherproof electrical boxes
fin heating  tubeing	fin heating tubing
9v battery ackup	9v battery backup
backsplash paneks	backsplash panels
spray paint rust-oleum gray	spray paint rustoleum gray
hampton baysolar bird lights	hampton bay solar bird lights
bathroom valnity lights	bathroom vanity lights
wall air conditioneer	wall air conditioner
15 in built in maytag trash compactorr	15 in built in maytag trash compactor
garden hose filter attactchent	garden hose filter attachment
40 gal liquid propan	40 gal liquid propane
granitne sealer	granite sealer
handheld seed speader	handheld seed spreader
cement boards ciding	cement boards siding
gas pire column	gas fire column
galvanized wire 10 guage	galvanized wire 10 gauge
1.4 cubit ft micro wave	1.4 cubic ft microwave
home decorators cinamon	home decorators cinnamon
hex shank drill bitt sets	hex shank drill bit sets
wesleyand	wesleyan
kitchen cabinte hardware blue knob	kitchen cabinet hardware blue knob
window flasheing	window flashing
octagon eve vents	octagon eave vents
combo powertool kit	combo power tool kit
eatrhwise mower blades	earthwise mower blades
12 sthel chainsaws	12 stihl chainsaws
solistone pebbble	solistone pebble
door threshholds	door thresholds
shorten pendent lighting	shorten pendant lighting
apriaire humidifier water panel	aprilaire humidifier water panel
pendent lights wit conversion kits	pendant lights with conversion kits
mmodel	model
vertical blind accsesories	vertical blind accessories
console tab;le	console table
lumionaire	luminaire
1/4 nich tee	1/4 inch tee
lawn mover wrench	lawn mower wrench
led energy efficient kitchen lites	led energy efficient kitchen lights
telescooping ladder	telescoping ladder
2x2 ceiling tilepantq22s	2x2 ceiling tile paint 22s
norton hot water heater ingniter	norton hot water heater igniter
hunter shower eshaust fan with light	hunter shower exhaust fan with light
white electrtical outlets	white electrical outlets
refrigerato 33 inch wide	refrigerator 33 inch wide
3 1/2 non-mortison hinges satin finish	3 1/2 non-mortise hinges satin finish
ccurved shower door	curved shower door
ventalation	ventilation
deep expresso walnut/new ellenton	deep espresso walnut/new ellenton
kitchen composie double sinks	kitchen composite double sinks
onyx sand porcelian	onyx sand porcelain
melinger hand truck wheals	melinger hand truck wheels
mansonry impact bit	masonry impact bit
bathun drain plunger	bathtub drain plunger
white acryl paint	white acrylic paint
glass towel bar braket	glass towel bar bracket
fire rated buildng materials	fire rated building materials
knoty pine fencing	knotty pine fencing
6x6 colunm caps	6x6 column caps
byfold doors	bifold doors
manuel venting sky light	manual venting skylight
corragated metal	corrugated metal
1x1 square tubeing	1x1 square tubing
micro wave ovens	microwave ovens
carbon fiber vinel	carbon fiber vinyl
10 foot step laddert	10 foot step ladder
26 in woodsaddle stool	26 in wood saddle stool
cub cadet 46 balde	cub cadet 46 blade
water proofing shower membrame	waterproofing shower membrane
dwarf pereniel plants	dwarf perennial plants
windowbalance	window balance
barbque grill temperature guage	barbecue grill temperature gauge
6 metal tee posts	6 metal t posts
airosol epoxy paint	aerosol epoxy paint
mta distributions log splitter	mta distributors log splitter
24 white walloven	24 white wall oven
water filter for vanitys	water filter for vanities
10 deep kitchen sink porcelin	10 deep kitchen sink porcelain
kitchen aide mixer	kitchenaid mixer
delta diverte rhandle in rb	delta diverter handle in rb
gas powere wood chipper	gas powered wood chipper
alure flooring black oak	allure flooring black oak
whirlpool  french door frig 30 wide	whirlpool french door fridge 30 wide
greenh wall paint	green wall paint
gliddon speed wall	glidden speed wall
roller up window blinds	roll up window blinds
whellbarrow	wheelbarrow
dyson ball allergy vaccume	dyson ball allergy vacuum
strended electrical wire	stranded electrical wire
outdoor unskid tiles	outdoor non skid tiles
pressuer washer	pressure washer
16 inch flourescent	16 inch fluorescent
matte bailey mohogany	matte bailey mahogany
bronzw phone wall jack cover	bronze phone wall jack cover
faucetskitchen	faucets kitchen
ralph laren brown paints	ralph lauren brown paints
washing machine plug adapator	washing machine plug adapter
pressure vaccuum breaker o-ring	pressure vacuum breaker o-ring
m4 50 srcew	m4 50 screw
vaccum hose	vacuum hose
pressure washerparts	pressure washer parts
chain link fenceing	chain link fencing
bmboo lattecie	bamboo lattice
led  circuline bulbs	led circline bulbs
kohler shower cartidges	kohler shower cartridges
window ac manuel operation	window ac manual operation
wndows	windows
ryobi blower with batery	ryobi blower with battery
air conditon cooper soft	air conditioner copper soft
bathroom facets	bathroom faucets
bananna leaves plant	banana leaves plant
wall mounteddrop leaf table	wall mounted drop leaf table
forimca	formica
pvc valvez	pvc valves
ceiling fan extension wre	ceiling fan extension wire
ew drops marquee paint	dew drops marquee paint
calutta marble laminate countertop	calcutta marble laminate countertop
window air conditionerriding lawn mowers	window air conditioner riding lawn mowers
pendent cealing fixture	pendant ceiling fixture
pest control diat	pest control diet
32  door threshhold	32 door threshold
ptouch labeling tape	p touch labeling tape
kitchenaid superb oven	kitchenaid superba oven
outdoor dining se?	outdoor dining set?
red devil scraperreplacement bldes	red devil scraper replacement blades
1/3 hoursepower garbage disposal	1/3 horsepower garbage disposal
wondow curtains	window curtains
kidcraft 18 doll furniture	kidkraft 18 doll furniture
stove excaust fan	stove exhaust fan
woodpeckers repellant	woodpeckers repellent
screws for deckin	screws for decking
pedistal	pedestal
1/4 in.-20 x 1 in. stainless steel flat-head socket cap scre	1/4 in.-20 x 1 in. stainless steel flat-head socket cap screw
metalic lquid tight	metallic liquid tight
vogoro flower	vigoro flower
greak	greek
rigid pipe threader	ridgid pipe threader
ryobl battery	ryobi battery
stainlss steel wire wheels	stainless steel wire wheels
8 foot flour sent	8 foot fluorescent
4 gallon expanion	4 gallon expansion
pro series vinal post	pro series vinyl post
craft an lawn mower	craftsman lawn mower
levinton phone tv combo	leviton phone tv combo
manuel for 425 - 1649	manual for 425 - 1649
1 infloor flange	1 in floor flange
rigid wet dry vac	ridgid wet dry vac
verneer edging tool	veneer edging tool
led recressed lighting	led recessed lighting
anderson storm door full view easy install	andersen storm door full view easy install
38 grainte composit sink	38 granite composite sink
kwikset passive door knob	kwikset passage door knob
Comercial electric	Commercial electric
daylight florisant bulb 36inch	daylight fluorescent bulb 36 inch
oil bronzed wine glass rack	oiled bronze wine glass rack
stainless steal hose clamps	stainless steel hose clamps
bix max 7x7	big max 7x7
veraluz 4 light bathroom vanity	varaluz 4 light bathroom vanity
stabilty	stability
9.6 bvolt	9.6 volt
exterior for pastic shutters	exterior for plastic shutters
summit 20 in elctric range	summit 20 in electric range
kithchen install	kitchen install
buddahs hand tree	buddha's hand tree
celling fans	ceiling fans
post white ligth	post white light
cicular saw blad	circular saw blade
tribecia	tribeca
trane 2.5 toon 13 seer heat pump	trane 2.5 ton 13 seer heat pump
samsungelectric ranges	samsung electric ranges
portabe bar	portable bar
22 bin plastic drawer parts storage organiz	22 bin plastic drawer parts storage organizer
cornor board	corner board
antique brass hindges for doors	antique brass hinges for doors
ryobi multi tool acccessories	ryobi multi tool accessories
tv shelv	tv shelf
sikalatexr concrete vonding adhesive	sikalatex concrete bonding adhesive
rigid nailer	ridgid nailer
pvc edgetape white	pvc edge tape white
ice ring machine	ice rink machine
duplex outlet and ubs charger	duplex outlet and usb charger
airconditioner decoritive  cover unit	air conditioner decorative cover unit
drils	drills
in the ground rodiron plant hanger	in the ground rod iron plant hanger
ridinng lawn mowers mulching	riding lawn mowers mulching
closet clothes rackclosetmaid	closet clothes rack closetmaid
mixet math faucet	mixet bath faucet
led hale gin g9	led halogen g9
rigid wet nozzelsqueegee	ridgid wet nozzle squeegee
external structual connector screw	external structural connector screw
flex gardn hose	flex garden hose
splitbolt connector	split bolt connector
4 x 4 pos cap	4x4 post cap
double curtain rod connecter	double curtain rod connector
savavieh soho	safavieh soho
pernennial grass seed	perennial grass seed
dual lock 3m veclro	dual lock 3m velcro
combination fan and lightwall switches	combination fan and light wall switches
under cabinet led light accesory pack	under cabinet led light accessory pack
outdoor pendant lioghting	outdoor pendant lighting
led withe	led white
hose to presure washer	hose to pressure washer
sintetic grass	synthetic grass
deck  fasting systems	deck fastening systems
ventenatural gas heater	vented natural gas heater
hanging worklight fixtures ceiling	hanging work light fixtures ceiling
tuscon patio pavers	tucson patio pavers
t fittin	t fitting
westminster pedistal combo	westminster pedestal combo
husqvarna presure washer	husqvarna pressure washer
freesstanding	free standing
DRAWEER PULLS	DRAWER PULLS
depp well socket set	deep well socket set
assemble hight 17 inches	assembled height 17 inches
plastic corrougeted roofing	plastic corrugated roofing
hand shovles	hand shovels
chritmas tree	christmas tree
u bents fluorescent	u bend fluorescent
whirlpool diswasher weather stripping	whirlpool dishwasher weather stripping
miricile applet or and tray	miracle applet or and tray
1 1/2inchbrasswalltube18 inch	1 1/2 inch brass wall tube 18 inch
48 inch aluminum shower curtin rod	48 inch aluminum shower curtain rod
spackilng knife	spackling knife
vynal floor matting	vinyl floor matting
lanscape timber	landscape timber
white vainty 8 faucet	white vanity 8 faucet
moen grab bar securemount	moen grab bar secure mount
robutussin dh 835 replacement wick	robitussin dh 835 replacement wick
stainless refridgerator	stainless refrigerator
out  door celing fan	outdoor ceiling fan
silcone	silicone
hardiboard siding	hardie board siding
white inyrtior paint	white interior paint
5/8 j chann	5/8 j channel
woper blades	wiper blades
defiant led armer max	defiant led armormax
costum key	custom key
sterio wire for indoor speakers	stereo wire for indoor speakers
warm espresso bamboo quarteround	warm espresso bamboo quarter round
washer  electic dryer	washer electric dryer
vent fllters	vent filters
pond filter mediumpond filter pads	pond filter media pond filter pads
polished brass 8 spread lavitory faucet	polished brass 8 spread lavatory faucet
bifold doorsfold plantation	bi fold doors fold plantation
foundstion vents	foundation vents
spectrazide ant	spectracide ant
frost fee freezers	frost free freezers
flourescent balast 120-2/32is	fluorescent ballast 120-2/32is
3 pane craftsman door	3 panel craftsman door
Allure mellowood flooring	Allure mellow wood flooring
electric guage cable	electric gauge cable
krud cutter rust	krud kutter rust
dakato 4 light	dakota 4 light
chrome/polished brass 2-handle 4-in centerset bathroom fauc	chrome/polished brass 2-handle 4-in centerset bathroom faucet
dorr faceplates	door faceplates
thermostat w remote senser	thermostat w remote sensor
edsel heavy duty 5	edsal heavy duty 5
acrylic primere	acrylic primer
levin 25 wat usb	levin 25 watt usb
singel wall stove pipe	single wall stove pipe
black and decker scub buster extreme	black and decker scrub buster extreme
gas pressure regular	gas pressure regulator
rubberaid dust mop	rubbermaid dust mop
ac air diverer	ac air diverter
large yellow screw inground anchors	large yellow screw in ground anchors
exhaustless portable airconditioner	exhaustless portable air conditioner
self sealant membrane	self sealing membrane
lg hausys viaterra	lg hausys viatera
doors exterior with top windo	doors exterior with top window
ryobi drill prass	ryobi drill press
vinal plank selection	vinyl plank selection
landscape  wateting	landscape watering
lawn mower- electic	lawn mower- electric
cover for pole structue	cover for pole structure
vinyl 1 bilnd	vinyl 1 blinds
sanding machinehardwood floors	sanding machine hardwood floors
american wood charllotesville natural hickory	american wood charlottesville natural hickory
air  bathtubes	air bathtubs
torino chandler 5 light bn	torino chandelier 5 light bn
5/8   floring plywood weatherproof	5/8 flooring plywood weatherproof
rain nickle	rain nickel
sliding door storage cabi nets	sliding door storage cabinets
stone vaneer	stone veneer
1/2 in.x 1/2 in. thread albow male to male	1/2 in.x 1/2 in. threaded elbow male to male
alumiun grove in	aluminum grove in
60 lb hi strength concrete	60 lb high strength concrete
curtain rod classic sqaure finial	curtain rod classic square finial
nals for subfloor	nails for subfloor
pvc threaded elbo	pvc threaded elbow
replacement patio unbrella pole	replacement patio umbrella pole
prunning shears	pruning shears
5/4 pressure treaded decking	5/4 pressure treated decking
fabric umbella	fabric umbrella
bathrub and shower wall kits	bathtub and shower wall kits
paper lawn  tefuse bags	paper lawn refuse bags
adhesive magnetized roll	adhesive magnetic roll
fire brick and morter	fire brick and mortar
fece posts metal	fence posts metal
3/4 in. pvc assesories	3/4 in. pvc accessories
chainsaw rplacement chains	chainsaw replacement chains
duplex receptacle nickle	duplex receptacle nickel
electric dyrer heater elemnet	electric dryer heater element
mirrir hanger	mirror hanger
round up nozzle replacment	roundup nozzle replacement
almeda hickory	alameda hickory
kitchen ceiling lightening	kitchen ceiling lighting
hoover prower scub deluxe	hoover power scrub deluxe
bufflo box wrench	buffalo box wrench
tuband tile latex caulk	tub and tile latex caulk
riverera screen doors	riviera screen doors
kichen island	kitchen island
suny citrus fertilizer	sunny citrus fertilizer
hasmmock bed	hammock bed
bed gugs	bed bugs
water filter for frigidaire refrigirator	water filter for frigidaire refrigerator
no tresspassing	no trespassing
coedless makita chainsaw with batteries	cordless makita chainsaw with batteries
heat resistant spicket	heat resistant spigot
rhee. 40 gallon water heaters	rheem. 40 gallon water heaters
dinning chair seats	dining chair seats
4in pvc electrcial boxes	4in pvc electrical boxes
ge discontinnued top freezers	ge discontinued top freezers
anderson storm door series 2500 sandtone polished brass	andersen storm door series 2500 sandstone polished brass
15 amp tampe resistant outlets	15 amp tamper resistant outlets
3/4 vlve	3/4 valve
shelac	shellac
skylifghts	skylights
cap screww everbilt 1/4in x2in	cap screw everbilt 1/4in x2in
wood qwik bolts	wood kwik bolts
serger sewimg machine	serger sewing machine
metl flashing	metal flashing
mixing tubn	mixing tub
portercable 6 gal	porter cable 6 gal
angle findeer	angle finder
hamptonbay shaker cabinets wall	hampton bay shaker cabinets wall
electical box	electrical box
whithaus faucet speckled brass	whitehaus faucet speckled brass
lp gas converion kit	lp gas conversion kit
outdooor carpet	outdoor carpet
rusteoulm spray paint	rustoleum spray paint
ironboard built in	iron board built in
1/2 in ree bar	1/2 in rebar
3 4  toilet phlange	3 4 toilet flange
tall black toliet	tall black toilet
stainless dishwaser smugde proof	stainless dishwasher smudge proof
sable browj 95	sable brown 95
heat reducing window flim	heat reducing window film
smoke dectectors	smoke detectors
sanding sponce	sanding sponge
idylus air purifier	idylis air purifier
kithen cabinets 18 white	kitchen cabinets 18 white
porta cool	portacool
whirlpoolgas stove	whirlpool gas stove
transformet for flurescent tube lights	transformer for fluorescent tube lights
sumpter oask	sumpter oak
pegasus ntique brass	pegasus antique brass
Whirpool washer	Whirlpool washer
metal trash cas	metal trash cans
toro springkler	toro sprinkler
hot water heating recirculitating pumps	hot water heater recirculating pumps
oilrubbed bronze 3/8in riser	oil rubbed bronze 3/8in riser
earthgrow mulch	earthgro mulch
unmortified mortor	unmodified mortar
rolling barn dorr hardware	rolling barn door hardware
hardi trim	hardietrim
proipane	propane
vacumns	vacuums
1x6 prime molding	1x6 primed molding
black and decker elctric	black and decker electric
helti tools	hilti tools
jimmyproof lock	jimmy proof lock
acuria lattace panels	acurio lattice panels
othor ant killer	ortho ant killer
shopvac filter hepa	shop vac filter hepa
smudge proof stainless steele	smudge proof stainless steel
patio  tbricks	patio bricks
1 1/4 galvenized steel pipe fittings	1 1/4 galvanized steel pipe fittings
barclay glass bathroom shelfs	barclay glass bathroom shelves
pergo lamate flooring	pergo laminate flooring
slidng panel lock	sliding panel lock
2700 br30 led	2700k br30 led
outdoor dust to dawn light	outdoor dusk to dawn light
2' flourescent lighting	2' fluorescent lighting
emser ocuntry	emser country
pendents amber	pendants amber
groung fault electric outlet	ground fault electrical outlet
milwakee M12	milwaukee M12
flourecent	fluorescent
double control shower vavle	double control shower valve
sod grass san agustino	sod grass san agustin
ge beverage refriderator	ge beverage refrigerator
well pump back presure valve	well pump back pressure valve
arcadia mettal  locks	arcadia metal locks
jogsaw tool	jigsaw tool
vynal tile	vinyl tile
14 gauge strranded wire	14 gauge stranded wire
Hose end nozzel	Hose end nozzle
weewacker edger	weed wacker edger
florsent  replacement diffuser	fluorescent replacement diffuser
24 inch lover doors	24 inch louvered doors
fungicidal seed innoculant	fungicidal seed inoculant
cultured marbl;e shower walls	cultured marble shower walls
dewalt 20 volt xr hamer	dewalt 20 volt xr hammer
screw driver 10 iches	screwdriver 10 inches
windser light coco	windsor light coco
scrren wire	screen wire
sppeed square	speed square
30 par haolgen bulbs	30 par halogen bulbs
curtains non black out	curtains not blackout
styrafoam	styrofoam
cedar bahr 502 stain	cedar behr 502 stain
barn doorspring latches	barn door spring latches
vinyl sheeti	vinyl sheet
eurothem thermostatic valve	eurotherm thermostatic valve
biscue dishwashers	bisque dishwashers
gfi circuit breaker	gfci circuit breaker
portabel tabel, plastic	portable table, plastic
mosia grout sealer	mosaic grout sealer
wallmount indoor lights with plug	wall mounted indoor lights with plug
air vents for plumping	air vents for plumbing
black chandelier wjth black shades	black chandelier with black shades
counterdepth fridge	counter depth fridge
roll jp door	roll up door
moen 7570 single hanlel faucet	moen 7570 single handle faucet
small tracerse rods	small traverse rods
crystable table set lamps	crystal table set lamps
drop celing tiles	drop ceiling tiles
vaccuum cleaners for hardwood and carpet	vacuum cleaners for hardwood and carpet
daltile urban camoflogue	daltile urban camouflage
greecian white porcelein marble	greecian white porcelain marble
varigated fiber board	variegated fiber board
6 pvc flixible coupling pipe	6 pvc flexible coupling pipe
basement window replacement insructions	basement window replacement instructions
mobile home extior doors	mobile home exterior doors
60x65shower doors	60x65 shower doors
webber spirit gas grill	weber spirit gas grill
vanitiy top back splach	vanity top backsplash
32' strorm door	32' storm door
troy build trimmer extension	troy bilt trimmer extension
elrctric welders	electric welders
24 regrigerators	24 refrigerators
bathtubdoor towel racks	bathtub door towel racks
steele stake	steel stake
12 roofing pannel	12 roofing panel
24 incyh range	24 inch range
icycle lights	icicle lights
phillips 65w 2 pack	philips 65w 2 pack
brushes drils	brushed drills
garge doors	garage doors
rigid sander	ridgid sander
2 in pvc pipe incresers	2 in pvc pipe increasers
wwod floor runner	wood floor runner
12 v landscaping ligtening fixture	12v landscape lighting fixture
16 inch fabn	16 inch fan
96 right hand miter tyhoon ice	96 right hand miter typhoon ice
100 watt candlabra bulb	100 watt candelabra bulb
20 gl. hose end sprayer	20 gal. hose end sprayer
small paint rollerss	small paint rollers
brown color scheem	brown color scheme
terra cota quarry stones	terracotta quarry stones
doublew stainless	double stainless
gavanized pipe 20 feet	galvanized pipe 20 feet
racheting wrench	ratcheting wrench
led track lightning systems	led track lighting systems
battery chages	battery charges
fint tube	find tube
oil rubbered bronze dor	oil rubbed bronze door
leminate floor alexandrea	laminate floor alexandria
outdoor screem	outdoor screen
36' copoktop	36' cooktop
12 inch sower head	12 inch shower head
stone are mb11	stone care mb11
telemechanic square d	telemecanique square d
lithum leaf blower	lithium leaf blower
55 inch cultured marble vanity tope	55 inch cultured marble vanity top
long handled squeege window cleaning	long handled squeegee window cleaning
swifer wet cloth	swiffer wet cloth
power drill battery an charger	power drill battery and charger
elaphent ear	elephant ear
new deck for rtz 50	new deck for rzt 50
paint markers burgondy color	paint markers burgundy color
home decorator outoddor patio cordless shades	home decorator outdoor patio cordless shades
hdc fairlawm jasper cane	hdc fairlawn jasper cane
tall 18 in storage cabnet	tall 18 in storage cabinet
kitchen mat boack	kitchen mat black
silocone repairs	silicone repairs
ASHPHALT SEALER	ASPHALT SEALER
wood ddeck kits	wood deck kits
2 tier adjustable cabinet orgainzer	2 tier adjustable cabinet organizer
light podt sensor	light post sensor
twin wsher dryer gas	twin washer dryer gas
medal stud finder	metal stud finder
bateries  9v	batteries 9v
crown moldinf jig	crown molding jig
vitarera quartz	viatera quartz
circular sawshop vac	circular saw shop vac
ceiling     light brackt	ceiling light bracket
carpet chessnut	carpet chestnut
progress piedmot	progress piedmont
decorative interor glass doors	decorative interior glass doors
playset handels	playset handles
baldwin lock stets	baldwin lock sets
preserva wood caryon	preserva wood crayon
traffic master porcelin ceramic tile portland stone	trafficmaster porcelain ceramic tile portland stone
hampton bay oak bast cabinets	hampton bay oak base cabinets
moen kitchen fauchet	moen kitchen faucet
75 qrt cooler  with wheels	75 quart cooler with wheels
pest repellant	pest repellent
silver branzing rods	silver brazing rods
pvc t coulpler	pvc t coupler
stapler hammers	staple hammers
bath rom toilets	bathroom toilets
everbilt sloted	everbilt slotted
kids outside furnature	kids outside furniture
12v replacement blubs	12v replacement bulbs
specticide weed and grass rtu refill	spectracide weed and grass rtu refill
pl gas hose	lp gas hose
playststion 4 destiny bundle	playstation 4 destiny bundle
stove top replacement patr	stove top replacement part
compreshion repair kit	compression repair kit
dealt air compressor parts	dewalt air compressor parts
fingerprint lockset	fingerprint locks
locktite 9oz 2in1 premium sealant	loctite 9oz 2in1 premium sealant
policarbonate case	polycarbonate case
7.5 mconnection for 9000 btu	7.5 connection for 9000 btu
12000 btuair conditioners window	12000 btu air conditioners window
edge glued rounda	edge glued rounds
garden seed packs	garden seed packets
wood lattace	wood lattice
solar powered emergancy unit	solar powered emergency unit
1/2 fpt x 1/2 inch pex	1/2 npt x 1/2 inch pex
leather lgue	leather glue
8 foot florescent light bulb	8 foot fluorescent light bulb
artifical ground cover	artificial ground cover
vynal fence	vinyl fence
mesquito spray	mosquito spray
6 pnl molded	6 panel molded
thinset morter	thin set mortar
2 ' galvanise street 90	2 ' galvanized street 90
ultra vue quick screeen	ultra vue quick screen
ac window supprt	ac window support
ding room set	dining room set
capital cap for colum	capital cap for column
milwaukee ha,,er drill	milwaukee hammer drill
lmainate boards	laminate boards
spiral latters	spiral letters
post sleeveee	post sleeve
outdoor cieling fans	outdoor ceiling fans
6 incn door knocker	6 inch door knocker
rustoleum  bright coach metallic	rustoleum bright coat metallic
3/8 rachert set	3/8 ratchet set
panle clamp	panel clamp
ul liquidthight 25	ul liquidtight 25
soild core flush pre hung door	solid core flush prehung door
replacement part for koehler toilet kb3	replacement part for kohler toilet kb3
engineered wood floorcleaners	engineered wood floor cleaners
ge electriv burners	ge electric burners
round one piece tiolet	round one piece toilet
49 inch napolian vanity top	49 inch napoleon vanity top
1/0 aqg	1/0 awg
isunderlayment requiered for metal roof	is underlayment required for metal roof
wahing machines	washing machines
10 flourescent bulbs	10 fluorescent bulbs
heavy duty extensoion cordyellow only	heavy duty extension cord yellow only
unbralla fabric top only	umbrella fabric top only
gerber knife tactiical	gerber knife tactical
cheapete gas 40 gallon hot water heater	cheapest gas 40 gallon hot water heater
purpor power	purple power
armstroung floor adhesive	armstrong floor adhesive
adhensive with nozzle	adhesive with nozzle
vinal flooring	vinyl flooring
merola metalic tile	merola metallic tile
ceiling mount electical box	ceiling mount electrical box
batroom fan heater light	bathroom fan heater light
shluter	schluter
lampsade pendent light	lamp shade pendant light
white cabnet 30 inch base	white cabinet 30 inch base
hdx pneumaitic paint	hdx pneumatic paint
door hinges for americana refrigator	door hinges for americana refrigerator
archor tub and shower faucet trim	archer tub and shower faucet trim
residental  light sensor security lights	residential light sensor security lights
minwax wood puty	minwax wood putty
30 entry door 9 litr	30 entry door 9 lite
dedwalt cordless drill	dewalt cordless drill
3 x 6 blace tile	3 x 6 black tile
wireless security caamera	wireless security camera
sflexible shower	flexible shower
built in landry shelving	built in laundry shelving
versatiube	versatube
anderson replacement double hung window 34.5x36.5	andersen replacement double hung window 34.5x 36.5
3.9 high effeciency front load washer	3.9 high efficiency front load washer
home depot in cambrige	home depot in cambridge
martha suart carpet tobacco leaf	martha stewart carpet tobacco leaf
makit 12v	makita 12v
tensil ties	tinsel ties
back yard weather forecasteer	backyard weather forecaster
unface insulation 23 inches wide	unfaced insulation 23 inches wide
savfavieh rug pad	safavieh rug pad
trigger makita skillsaw	trigger makita skil saw
prppane pan	propane pan
outdoor faucwts	outdoor faucets
hampton pation set with firepit	hampton patio set with firepit
artifical turf border	artificial turf border
rigid portable tool boxes	ridgid portable tool boxes
knotches	notches
blind replacemetn	blind replacement
drywall panel hoisst	drywall panel hoist
ne angle base	neo angle base
roudulf	rudolf
fantsastic	fantastic
whirpool range hood 36	whirlpool range hood 36
16d framin	16d framing
celing light holder	ceiling light holder
toliet snake	toilet snake
car canoply	car canopy
3x3 diamond thread plate	3x3 diamond tread plate
tigerwood perigo laminate flooring	tigerwood pergo laminate flooring
galvinized conduit pipe	galvanized conduit pipe
chamberlain chain  and pulliepaarts	chamberlain chain and pulley parts
weldn 3	weldon 3
ac air vent sleave	ac air vent sleeve
new age produucts	new age products
john deere d100 sereissnow blade	john deere d100 series snow blade
swanstone kitchen sink accesories	swanstone kitchen sink accessories
weekender powerwasher extension arms	weekender power washer extension arms
point of use electtric	point of use electric
24 inches rerefrigerator	24 inches refrigerator
cutkler hammer breaker	cutler hammer breaker
aaa batteries everready gold	aaa batteries eveready gold
padtio heater	patio heater
no tresspassing signs	no trespassing signs
galvinized nails 3	galvanized nails 3
garden host 50	garden hose 50
shower door sealparts	shower door seal parts
polyeurethane exterior	polyurethane exterior
cushions for wecker furniture	cushions for wicker furniture
elongagated toilet seat	elongated toilet seat
20a wht nylon duple	20a wht nylon duplex
20 ft electical romex	20 ft electrical romex
clacier bay toliet	glacier bay toilet
hex drill chcuck	hex drill chuck
potable air conditioner	portable air conditioner
flourescent light bulp	fluorescent light bulb
polycarbonite	polycarbonate
sweeep pan	sweep pan
kenocen can nozzle	kenken can nozzle
flexible pvc joing	flexible pvc joint
led rop light clips	led rope light clips
exterior string ligts	exterior string lights
universal exstention cord	universal extension cord
32 x 32 shower baser	32 x 32 shower base
receptical	receptacle
bouganvilla	bougainvillea
1/2 in. fip x 7/16 in. or 1/2 in. slip joint angle stop valv	1/2 in. fip x 7/16 in. or 1/2 in. slip joint angle stop valve
storage buiding 12' x 20'	storage building 12' x 20'
behr melrot	behr merlot
glass sheet mosiacs	glass sheet mosaics
klein 8 inch plies	klein 8 inch pliers
light for public ligthining	light for public lightning
dim able balafon flood light	dimmable balafon flood light
b10  led bub	b10 led bulb
door knobsw	door knobs
outdoor gas fiepits	outdoor gas firepits
hickory hadwre touch of spring	hickory hardware touch of spring
umbrell hole ring	umbrella hole ring
granitecounter top cararra	granite countertop carrara
33 in w x 18 icnh depth vanity	33 in w x 18 inch depth vanity
6' remodel can valted celing  cans	6' remodel can vaulted ceiling cans
wooden track drawer replacment	wooden track drawer replacement
split line air conditioing	split line air conditioning
shop ceiling fane	shop ceiling fan
trafficmaster interloclk	trafficmaster interlock
super patch driverway sealler	super patch driveway sealer
bathroom pendastal	bathroom pedestal
buth tub faucet	bathtub faucet
2 inch bye 6 inch thick board	2 inch by 6 inch thick board
door knobs exteria	door knobs exterior
amdry wallpanel	amdry wall panel
18 volt 1/2 roter hammer	18 volt 1/2 roto hammer
jigsaww blades	jigsaw blades
asathbula 7 piece	ashtabula 7 piece
24 inflex gas line	24 in flex gas line
outdoor alrm	outdoor alarm
ridiing lawnmower	riding lawn mower
stainless steel refridgerator	stainless steel refrigerator
metal gringing weel  5/8	metal grinding wheel 5/8
everblit heavy duty canvas dropcloth	everbilt heavy duty canvas drop cloth
oreck full reease carpet cleaner	oreck full release carpet cleaner
huskey 18	husky 18
sockets for  fluorescence fixtres	sockets for fluorescent fixtures
pre-emergent weed contro	pre-emergent weed control
shevles	shelves
sissors	scissors
tall toliet	tall toilet
rigid lithium ion batteries fuego drill	ridgid lithium ion batteries fuego drill
high efficiency dust baf rigid vac	high efficiency dust bag ridgid vac
cooper tubing	copper tubing
patio dinning tables	patio dining tables
femle end hose repair	female end hose repair
viyle fencing	vinyl fencing
beer and wine combination frigerator	beer and wine combination refrigerator
green carpert	green carpet
siegel light pendent	siegel light pendant
jefrrey court 3x12	jeffrey court 3x12
heirloom whie	heirloom white
4x7 ruggs	4 x 7 rugs
water putifiers	water purifiers
pool vaccum	pool vacuum
1/2 hp genie screw drive garage door openner	1/2 hp genie screw drive garage door opener
barbque grills	barbecue grills
pellitized lime	pelletized lime
exide battery 75,car battrey	exide battery 75,car battery
gorilla gold cpvc gluetm	gorilla gold cpvc glue
passload	paslode
light tropper 2x4	light troffer 2x4
sensor porch ligts	sensor porch lights
stailess steel top stoves	stainless steel top stoves
indoor grow light blubs	indoor grow light bulbs
ge diswasher	ge dishwasher
pool suppll	pool supply
3/8 entension	3/8 extension
riding mower blabes	riding mower blades
steel tubing falanges	steel tubing flanges
lithium batties	lithium batteries
closetr rod	closet rod
abs rambit pipe saver	abs rambut pipe saver
spray sealent for showers	spray sealant for showers
cordless sweeperr	cordless sweeper
1/2'  extirior plywood	1/2' exterior plywood
1/4 28 threadded connector	1/4 28 threaded connector
hansgroph faucets bathroom	hansgrohe faucets bathroom
penedtrating stain	penetrating stain
scrubbin sponge	scrubbing sponge
pri meld flush bi fold doors	primed flush bifold doors
suspanded ceiling	suspended ceiling
stone venner sequia	stone veneer sequoia
7 in. stove pie	7 in. stove pipe
2 ton expoxy	2 ton epoxy
samsong stive	samsung stove
threader rod end coupler	threaded rod end coupler
flourscent lights size 18x24	fluorescent lights size 18x24
black and decker hobby crafter	black and decker hobbycrafter
padio door	patio door
well pump submerciable	well pump submersible
garvanized wood screws	galvanized wood screws
woodwen pallet	wooden pallet
artric air portable	arctic air portable
lithium 20 dewalt	lithium 20v dewalt
above ground pool vaccume	above ground pool vacuum
storeage	storage
marble qwhite	marble white
bilt in pool	built in pool
electric  hock for lift	electric shock for lift
high temperate sealant	high temperature sealant
garbage desposal	garbage disposal
slate timberland shingle	slate timberline shingle
makita planner knives	makita planer knives
wire shelv liner	wire shelf liner
rectangulat wihite ceramic sink bathroom	rectangular white ceramic sink bathroom
4 inch back flow prenter	4 inch backflow preventer
indoor/otdoor extensions cords e176194	indoor/outdoor extension cords e176194
black dimmable gimble lights	black dimmable gimbal lights
powder clorine shock treatment	powder chlorine shock treatment
stone baxksplash	stone backsplash
cord less drill portcable	cordless drill porter cable
foam insulatino	foam insulation
portable air conditionar and heater	portable air conditioner and heater
fridigidaire drop in oven	frigidaire drop in oven
bath wall tile chanpayne	bath wall tile champagne
wood veener facing for kitchen cabinets	wood veneer facing for kitchen cabinets
halligon light bulb	halogen light bulb
spring haven brown all weather wicked	spring haven brown all weather wicker
makita drill batterie charger	makita drill battery charger
intersate battery	interstate battery
picture haning kitpicture hanging kit	picture hanging kit picture hanging kit
moen dhower faucet	moen shower faucet
black patioo set	black patio set
porble toilets	portable toilets
sqeaky carpet stair kit	squeaky carpet stair kit
windows single hang	windows single hung
gerber daisy	gerbera daisy
steel shelve	steel shelf
15 water depth bathub	15 water depth bathtub
solor power lighting  for exterior	solar power lighting for exterior
14 metal abresive blade	14 metal abrasive blade
battey string trimmers	battery string trimmers
windows gazing bead	windows glazing bead
paint for aluminun siding	paint for aluminum siding
americian standard champion 4 toliets	american standard champion 4 toilets
oscilliating too	oscillating tool
galvanaized can	galvanized can
diining set outdoor	dining set outdoor
carpet in bassment	carpet in basement
hoovwe cordless vacuum cleaners	hoover cordless vacuum cleaners
extorior shatters	exterior shutters
plastic splash guarf	plastic splash guard
solar  powerd lights	solar powered lights
alameda hickey laminate	alameda hickory laminate
glass panel retiner	glass panel retainer
washer/dryr	washer/dryer
4 center lavatory facuet	4 center lavatory faucet
Painting Cabniets	Painting Cabinets
ajustable ladder feet	adjustable ladder feet
exhust fan	exhaust fan
standing town rack	standing towel rack
24 whtie storage cabinet	24 white storage cabinet
electrichot water heaters residential	electric hot water heaters residential
for rent sighn	for rent sign
moen 4 port pex vavle	moen 4 port pex valve
icey tech	icey tek
artci shag rug	arctic shag rug
4 fluorescant fixture covers	4 fluorescent fixture covers
roller bracker for frameless shower doors	roller bracket for frameless shower doors
space heatres	space heaters
vauhhan hammers	vaughan hammers
COMPLET SHOWER KIT	COMPLETE SHOWER KIT
brown blasplash tile	brown backsplash tile
chamber-top halifax glass dooor	chamber-top halifax glass door
rust oleum cabinet stain kit	rustoleum cabinet stain kit
grohsafe roughin valve 35015	grohsafe rough in valve 35015
18.5 outside chair cushiobs	18.5 outside chair cushions
pendant shads	pendant shades
30 mirrow medicine cabinet	30 mirrored medicine cabinet
sschlueter shower system	schluter shower system
kitchen faucet installtion tools	kitchen faucet installation tools
portable airconditioner	portable air conditioner
psint gun	paint gun
ridgid wrachet head	ridgid ratchet head
solar naturlas salt	solar naturals salt
omen single hole bathroom faucet	moen single hole bathroom faucet
veeneer wood tape	veneer wood tape
rubber gromet	rubber grommet
frigidaire washer door striker/catch	frigidaire washer door striker/latch
kohler wellworth tpoilet	kohler wellworth toilet
ceilng fan	ceiling fan
28 snow thower	28 snow thrower
door home secutity	door home security
wall design cermic	wall design ceramic
tomatoe plants	tomato plants
wainscote	wainscot
relief valve for  rudd hot water heater	relief valve for ruud hot water heater
home security camera cablee	home security camera cable
show me all 60 inch vaniteis	show me all 60 inch vanities
air /heaterconditioner window	air /heat conditioner window
exterior pipeinsulation	exterior pipe insulation
high loss natural jabota	high loss natural jatoba
natural gas barbeque	natural gas barbecue
mulcing blades for troy built	mulching blades for troy bilt
deltile 3x6 ceramic blue	daltile 3x6 ceramic blue
1/2 ntp to 1/2	1/2 npt to 1/2
laundry tub fosets valves	laundry tub faucets valves
kohler claxton biscuit sink	kohler caxton biscuit sink
tun faucet spout	tub faucet spout
shower curtin rod	shower curtain rod
lights and siloutte	lights and silhouette
aluminum l cahnnel	aluminum l channel
dawn to dusk lig	dawn to dusk light
t8 flourescent bulbs	t8 fluorescent bulbs
network agapter	network adapter
garage shelf unjit	garage shelf unit
flourescent paint	fluorescent paint
concord charcole runner	concord charcoal runner
cambria java refridgerator	cambria java refrigerator
18in hardware coth	18in hardware cloth
insallation	installation
hindges	hinges
round flat topmetal post caps	round flat top metal post caps
fire restaint paint	fire resistant paint
porcelin floor tile 6x24	porcelain floor tile 6x24
whirlpool light bulb part 8206232	whirlpool light bulb part 8206232a
rutland wood stove termometer	rutland wood stove thermometer
front door with side transome	front door with side transom
tub facet set	tub faucet set
bathroom sinks kholer	bathroom sinks kohler
garage door 70 lb extention spring	garage door 70 lb extension spring
toilet saftey seat	toilet safety seat
f 30  flourescent light fixture	f30 fluorescent light fixture
chelsea white acrylic oval in rectangl	chelsea white acrylic oval in rectangle
hibascus plant	hibiscus plant
floor ceramick	floor ceramic
white pendant uplight	white pendant light
grow boz and pots	grow box and pots
1 handle tub and shower faucet shower and tub vlaves	1 handle tub and shower faucet shower and tub valves
siccsers	scissors
gas grill accesories	gas grill accessories
oride plant	pride plant
compsit outside corner	composite outside corner
cordless edgere	cordless edger
4 flourescent	4 fluorescent
stainless steel kithen faucet with soap dispenser	stainless steel kitchen faucet with soap dispenser
meguire plastic cleaner	meguiars plastic cleaner
steel enrty doors	steel entry doors
graveless gravaless sewer pipe	graveless graveless sewer pipe
table for outsde	table for outside
alumanam  sheets	aluminum sheets
mosiac lamps	mosaic lamps
